annee,cumul_periode,rss,region,nom_etablissement,nom_installation,no_permis_installation,nb_visites_total,nb_usagers_75ans_et_plus_total,nb_usagers_sante_mentale_total,dms_total,nb_usagers_pec_total,delai_pec_total,nb_visites_ambulatoire,nb_usagers_75ans_et_plus_amb,nb_usagers_sante_mentale_amb,dms_ambulatoire,nb_usagers_pec_ambulatoire,delai_pec_ambulatoire,nb_visites_sur_civiere,nb_usagers_sur_civiere_plus_24h,nb_usagers_sur_civiere_plus_48h,dms_sur_civiere,nb_usagers_pec_sur_civiere,delai_pec_sur_civiere,nb_usagers_75ans_et_plus_civ,nb_usagers_sante_mentale_civ
2020-2021,10,99,Total provincial,Total provincial,Total provincial,,2071654,321613,139561,8.0291570272,1786542,1.8477936341,1329540,105611,55269,3.7678062135,1049960,2.1833933264,742114,147558,35935,15.663612597,736582,1.3694134228,216002,84292
2021-2022,10,99,Total provincial,Total provincial,Total provincial,,2590367,381949,158058,8.4446627806,2115744,2.5048783413,1753292,137675,66250,4.5627308488,1286031,2.9750302801,837075,181461,47701,16.57554735,829713,1.7761565207,244274,91808
2022-2023,10,99,Total provincial,Total provincial,Total provincial,,2788583,409982,156173,9.0242922151,2207500,2.8505173113,1926500,149760,63861,4.963070343,1354533,3.3930415038,862083,209181,64216,18.09991943,852967,1.9889752798,260222,92312
2023-2024,10,99,Total provincial,Total provincial,Total provincial,,2722052,438674,158321,8.982975069,2199084,2.8283534845,1831942,164924,63000,4.9407537238,1318472,3.3452438201,890110,205945,55260,17.302300833,880612,2.0544537028,273750,95321
2024-2025,10,99,Total provincial,Total provincial,Total provincial,,2935029,479061,169392,8.9103884132,2355447,3.015403502,1977880,181285,66808,5.0882684898,1409169,3.5806794732,957149,212360,51717,16.808526064,946278,2.17361137,297776,102584
2020-2021,10,08,Abitibi-Témiscamingue,Total régional,Total régional,,68497,8034,4318,5.1218858328,58995,2.0000127224,55169,4383,3231,3.7552498585,45713,2.2081815652,13328,1289,159,10.778844121,13282,1.2835526778,3651,1087
2020-2021,10,01,Bas-Saint-Laurent,Total régional,Total régional,,77969,13566,3567,3.9011363419,68511,1.2921543499,56016,6060,2140,2.5232223432,46782,1.426781211,21953,281,0,7.4170672194,21729,1.0023060452,7506,1427
2020-2021,10,03,Capitale-Nationale,Total régional,Total régional,,226891,37011,14529,7.3565761068,196658,1.4433796306,143214,12490,4728,3.1953400932,113248,1.7712703928,83677,14342,3180,14.478572049,83410,0.9981935253,24521,9801
2020-2021,10,12,Chaudière-Appalaches,Total régional,Total régional,,112203,18966,5790,5.5906055839,97902,0.8938046692,77110,6803,2639,2.3980835747,62840,1.061569524,35093,4290,336,12.605547941,35062,0.5931274837,12163,3151
2020-2021,10,09,Côte-Nord,Total régional,Total régional,,58803,6740,3298,5.9502825205,47708,1.8788155376,45606,3531,2000,3.1240316272,35301,1.9334371705,13197,2280,1088,15.717199111,12407,1.7234034103,3209,1298
2020-2021,10,05,Estrie,Total régional,Total régional,,141788,21797,8722,7.4100887083,123771,2.0713325617,87473,6721,2959,3.9580519036,69716,2.5848538595,54315,8062,1494,12.969510883,54055,1.4090321124,15076,5763
2020-2021,10,11,Gaspésie-Îles-de-la-Madeleine,Total régional,Total régional,,55040,8905,2284,4.5692683251,49475,1.2143842064,42676,4856,1516,2.5587215427,37373,1.2986618162,12364,1424,384,11.508939506,12102,0.9541208524,4049,768
2020-2021,10,14,Lanaudière,Total régional,Total régional,,86834,13747,6036,9.3026577435,70995,2.4061374666,52972,3699,2946,4.7828007721,37380,3.0350236015,33862,7946,1040,16.373293367,33615,1.7068138397,10048,3090
2020-2021,10,15,Laurentides,Total régional,Total régional,,116055,17631,8770,10.544531563,96892,2.7032869615,72241,5642,3136,5.0054306419,53338,3.3685096825,43814,11836,3620,19.677461441,43554,1.8886281589,11989,5634
2020-2021,10,13,Laval,Total régional,Total régional,,55188,9619,3962,8.4389321602,44570,2.1566241057,34831,2618,1157,4.2474595746,24261,2.7222299049,20357,3887,294,15.610577374,20309,1.4809550774,7001,2805
2020-2021,10,04,Mauricie et Centre-du-Québec,Total régional,Total régional,,144684,24148,8834,6.1474011466,121804,1.8986657982,90947,7208,3018,3.2621679537,68549,2.3077664842,53737,4957,322,11.030504096,53255,1.3720778174,16940,5816
2020-2021,10,06,Montréal,Total régional,Total régional,,494111,71893,41294,10.180751625,449409,1.8070991149,289584,17750,14479,4.535652857,246440,2.2460555916,204527,53079,14413,18.173487457,202969,1.2741288872,54143,26815
2020-2021,10,16,Montérégie,Total régional,Total régional,,235507,40637,16754,9.9457085352,193206,2.1790340348,148986,12521,6840,4.1467439633,106939,2.6074285782,86521,25476,7438,19.931313599,86267,1.6479841075,28116,9914
2020-2021,10,07,Outaouais,Total régional,Total régional,,93919,12727,5980,7.7473214182,74170,2.2603798294,65535,5306,2578,3.6788234404,46214,2.2596736318,28384,6247,2019,17.140959206,27956,2.2615472429,7421,3402
2020-2021,10,02,Saguenay-Lac-Saint-Jean,Total régional,Total régional,,104165,16192,5423,5.2142704977,92476,1.6899630805,67180,6023,1902,2.8070477986,55866,1.9036718716,36985,2162,148,9.5867788368,36610,1.3638484855,10169,3521
2021-2022,10,08,Abitibi-Témiscamingue,Total régional,Total régional,,83532,9048,4929,5.7681191207,68253,2.7095492302,68704,5046,3679,4.4212410566,53541,2.9993433122,14828,1858,270,12.008738929,14712,1.6549091445,4002,1250
2021-2022,10,01,Bas-Saint-Laurent,Total régional,Total régional,,100160,15745,4231,4.1017010339,87254,1.7591367572,75496,7747,2647,3.0132551504,62907,1.9496926592,24664,406,6,7.4334116413,24347,1.2667845114,7998,1584
2021-2022,10,03,Capitale-Nationale,Total régional,Total régional,,279914,43092,15743,7.0524912017,232977,1.7989200329,186506,16351,5383,3.6386279292,139898,2.2523358586,93408,14919,2815,13.868887908,93079,1.1174347657,26741,10360
2021-2022,10,12,Chaudière-Appalaches,Total régional,Total régional,,156037,24103,7294,5.7630260024,135230,1.3642365723,114661,9856,3545,2.9490926635,93893,1.6127237358,41376,6476,643,13.560986428,41337,0.7998219983,14247,3749
2021-2022,10,09,Côte-Nord,Total régional,Total régional,,74378,8232,4188,6.7863776438,59732,2.434119958,58410,4448,2603,3.9168611349,44189,2.5251515586,15968,3035,1483,17.282899393,15543,2.1753156476,3784,1585
2021-2022,10,05,Estrie,Total régional,Total régional,,172904,25679,9552,8.0474830076,144132,2.8673927892,110691,8426,3490,4.826894345,82282,3.6665943037,62213,10441,2038,13.777638757,61850,1.8041769604,17253,6062
2021-2022,10,11,Gaspésie-Îles-de-la-Madeleine,Total régional,Total régional,,71843,11146,2900,4.8930409442,63456,1.644309933,57607,6617,1964,3.0493398565,49476,1.7565956221,14236,1937,461,12.353710273,13980,1.2469246145,4529,936
2021-2022,10,14,Lanaudière,Total régional,Total régional,,107879,17230,6869,9.9586079234,81061,3.3818738495,70906,5275,3685,5.8746073988,44287,4.3340616823,36973,10718,1302,17.790813619,36774,2.2351521833,11955,3184
2021-2022,10,15,Laurentides,Total régional,Total régional,,139566,21817,9496,12.176760057,106664,3.6477130652,92042,7672,3519,6.1900899378,59489,4.5412885482,47524,17128,6329,23.771429932,47175,2.5208892834,14145,5977
2021-2022,10,13,Laval,Total régional,Total régional,,68609,11118,4352,8.4179448032,52927,2.819525363,45341,3309,1285,4.8783485942,29726,3.5863187763,23268,4106,291,15.315350326,23201,1.8370805976,7809,3067
2021-2022,10,04,Mauricie et Centre-du-Québec,Total régional,Total régional,,183517,29155,9918,6.9043878163,144565,2.9018505036,121632,9478,3499,4.3990518417,83650,3.5650907551,61885,7371,346,11.828505539,60915,1.9910724188,19677,6419
2021-2022,10,06,Montréal,Total régional,Total régional,,635143,86130,47260,10.3433216,540179,2.5058857198,397756,23432,17705,5.4795995277,305170,3.1601770525,237387,61774,17712,18.492776443,235009,1.6562583182,62698,29555
2021-2022,10,16,Montérégie,Total régional,Total régional,,282358,46940,18084,10.816934478,206617,3.1986384591,188244,16127,7792,5.2414807378,112979,3.8375799952,94114,30009,10511,21.968789822,93638,2.4277230635,30813,10292
2021-2022,10,07,Outaouais,Total régional,Total régional,,106256,13725,6799,8.108272576,82508,2.3268744849,77942,6327,3061,3.8671283027,54637,2.3401214633,28314,7271,3050,19.783177815,27871,2.3009057304,7398,3738
2021-2022,10,02,Saguenay-Lac-Saint-Jean,Total régional,Total régional,,128271,18789,6443,5.9044215935,110189,2.3249537512,87354,7564,2393,3.4670489172,69907,2.6219812433,40917,4012,444,11.107986194,40282,1.8094803165,11225,4050
2022-2023,10,08,Abitibi-Témiscamingue,Total régional,Total régional,,88573,9515,4665,6.1392353012,73664,2.9833221678,73101,5126,3386,4.8048413496,58332,3.2749024025,15472,1977,327,12.44388449,15332,1.8739784257,4389,1279
2022-2023,10,01,Bas-Saint-Laurent,Total régional,Total régional,,110650,17182,3931,4.3766647211,94853,1.9670216575,83556,8074,2364,3.1819833372,68215,2.1410243145,27094,790,30,8.0609785069,26638,1.521432978,9108,1567
2022-2023,10,03,Capitale-Nationale,Total régional,Total régional,,301243,46510,15660,7.4257095352,244706,1.974297051,202747,17746,5622,3.7754527495,146768,2.4536064855,98496,17512,4317,14.939503116,97938,1.2560131665,28764,10038
2022-2023,10,12,Chaudière-Appalaches,Total régional,Total régional,,189346,27968,7705,6.1142134549,161727,1.7637231226,147263,12875,4074,3.3751988921,119696,2.0656614047,42083,9251,1703,15.69897456,42031,0.9038624335,15093,3631
2022-2023,10,09,Côte-Nord,Total régional,Total régional,,79298,8616,3844,6.6297825887,62998,2.8821519202,63126,4797,2491,4.4790077253,47209,3.0276770319,16172,2769,1107,15.025145811,15789,2.4470328499,3819,1353
2022-2023,10,05,Estrie,Total régional,Total régional,,186129,27634,9503,8.7879675595,149874,3.3651347873,122598,9162,3264,5.4201512826,86701,4.3762387945,63531,13014,3054,15.286960806,63173,1.9774576384,18472,6239
2022-2023,10,11,Gaspésie-Îles-de-la-Madeleine,Total régional,Total régional,,78435,12327,3062,5.4504238506,68631,1.9760459478,63790,7498,2048,3.5039673887,54272,2.1216281467,14645,2380,759,13.928707067,14359,1.4257961325,4829,1014
2022-2023,10,14,Lanaudière,Total régional,Total régional,,112852,18450,6678,10.980255709,79403,3.9712312297,76412,5753,3578,6.3709982471,43140,5.0448411503,36440,12350,3041,20.645529615,36263,2.6940194168,12697,3100
2022-2023,10,15,Laurentides,Total régional,Total régional,,148760,23502,9396,12.370324533,109316,4.0680678339,99410,8189,3197,6.5595123199,60363,5.0308553759,49350,18157,6641,24.075549296,48953,2.880873088,15313,6199
2022-2023,10,13,Laval,Total régional,Total régional,,72579,12180,4414,9.3561265885,53907,3.2350124546,48347,3474,1290,5.5735865261,29766,4.1724498216,24232,5611,454,16.902943376,24141,2.0791464728,8706,3124
2022-2023,10,04,Mauricie et Centre-du-Québec,Total régional,Total régional,,191426,30374,9452,7.8265514989,145851,3.2672510054,128460,9894,2928,4.8481492293,83896,4.0936547763,62966,10666,1445,13.902934873,61955,2.1481811844,20480,6524
2022-2023,10,06,Montréal,Total régional,Total régional,,672749,91171,47074,11.134736775,545394,2.823472048,427279,24587,16960,5.9380521665,303313,3.6906402499,245470,69276,23162,20.180380653,242081,1.7369622071,66584,30114
2022-2023,10,16,Montérégie,Total régional,Total régional,,291972,49031,17424,11.683303746,206388,3.634924818,199331,17380,7126,5.7931918281,114229,4.2573031975,92641,31757,13079,24.356762569,92159,2.8635008669,31651,10298
2022-2023,10,07,Outaouais,Total régional,Total régional,,123076,15279,6649,8.932929247,90958,2.9527944918,92202,7066,2981,4.3970038279,60730,3.0020447793,30874,8731,4353,22.479000229,30228,2.8538474906,8213,3668
2022-2023,10,02,Saguenay-Lac-Saint-Jean,Total régional,Total régional,,141495,20243,6716,6.3270050964,119830,2.7258076117,98878,8139,2552,3.867773547,77903,3.0428698474,42617,4940,744,12.032800838,41927,2.1366860588,12104,4164
2023-2024,10,08,Abitibi-Témiscamingue,Total régional,Total régional,,85446,10084,4464,6.214446512,72393,2.8517625054,68996,5481,3168,4.8492468404,56120,3.1397740803,16450,1852,334,11.940483992,16273,1.8585092894,4603,1296
2023-2024,10,01,Bas-Saint-Laurent,Total régional,Total régional,,103919,18174,4232,4.7171102761,90398,1.9911029282,77382,8885,2475,3.3397644945,64310,2.1827970637,26537,1197,141,8.7334561807,26088,1.5185542523,9289,1757
2023-2024,10,03,Capitale-Nationale,Total régional,Total régional,,295470,49898,16022,7.4139325951,244253,1.9914217055,195163,18954,5755,3.7771520131,144584,2.4625383476,100307,17243,3547,14.489859587,99669,1.3080002949,30944,10267
2023-2024,10,12,Chaudière-Appalaches,Total régional,Total régional,,182884,29157,7703,5.8901923836,158364,1.843515819,142632,14157,4080,3.401642278,118164,2.1686615965,40252,7265,1413,14.708310208,40200,0.8877813502,15000,3623
2023-2024,10,09,Côte-Nord,Total régional,Total régional,,76884,8952,4078,6.2647569426,61413,2.7290657335,60650,5172,2588,3.9620339516,45552,2.8670426533,16234,2872,1026,14.867698264,15861,2.3328029093,3780,1490
2023-2024,10,05,Estrie,Total régional,Total régional,,180832,29334,9635,8.7675239433,148960,3.3273229913,118137,10621,3431,5.39692103,86593,4.2769179187,62695,12681,2717,15.118794641,62367,2.0088649357,18713,6204
2023-2024,10,11,Gaspésie-Îles-de-la-Madeleine,Total régional,Total régional,,75397,12743,2991,5.3298924434,67175,1.8107728818,60605,7740,1981,3.3226213,52582,1.9383579615,14792,2468,588,13.553977601,14593,1.35105393,5003,1010
2023-2024,10,14,Lanaudière,Total régional,Total régional,,112418,20234,7009,10.644304782,81322,4.0001600599,74147,6680,3706,6.2489507555,43272,5.0089437807,38271,11944,2079,19.159951486,38050,2.852930384,13554,3303
2023-2024,10,15,Laurentides,Total régional,Total régional,,146324,25962,9925,11.993527915,110886,3.9769485728,95241,9331,3130,6.5450850007,60251,4.9697844572,51083,17296,5399,22.151802714,50635,2.7955650461,16631,6795
2023-2024,10,13,Laval,Total régional,Total régional,,69561,13493,4348,9.7876321342,54277,3.0068660093,44223,4116,1040,5.4492635619,28999,3.8419205739,25338,5831,653,17.359487583,25278,2.048888823,9377,3308
2023-2024,10,04,Mauricie et Centre-du-Québec,Total régional,Total régional,,185265,32328,9344,7.4090562842,145790,3.0066325041,120865,10694,2926,4.5830796297,82485,3.7354556889,64400,8944,821,12.712808898,63305,2.0569921851,21634,6418
2023-2024,10,06,Montréal,Total régional,Total régional,,660215,95814,47445,11.163126995,543931,2.6956648071,406419,26909,16447,5.7297532985,293190,3.4999601112,253796,70783,21674,19.863919381,250741,1.7552069632,68905,30998
2023-2024,10,16,Montérégie,Total régional,Total régional,,290771,54373,17549,11.376924235,213308,3.8028851525,186500,19408,6668,6.0968911558,109876,4.4894023591,104271,31941,10407,20.820836437,103432,3.0735966867,34965,10881
2023-2024,10,07,Outaouais,Total régional,Total régional,,119384,16348,6551,9.7201379791,89151,3.460876774,87515,7531,2811,5.1227914135,58096,3.4234038153,31869,9548,4151,22.344844895,31055,3.530979141,8817,3740
2023-2024,10,02,Saguenay-Lac-Saint-Jean,Total régional,Total régional,,137282,21780,7025,6.1955981038,117463,2.6927780497,93467,9245,2794,3.8610818108,74398,3.0219408452,43815,4080,310,11.175633123,43065,2.1241247662,12535,4231
2024-2025,10,08,Abitibi-Témiscamingue,Total régional,Total régional,,94059,11491,4972,6.3457381744,78815,3.2285270676,76420,6413,3627,5.1014176699,61385,3.5620126117,17639,2063,287,11.736688509,17430,2.0540571811,5078,1345
2024-2025,10,01,Bas-Saint-Laurent,Total régional,Total régional,,115802,19738,4538,4.7545630689,100305,2.073975497,89295,10116,2748,3.3808992478,74180,2.2804149891,26507,1623,168,9.3820694219,26125,1.4878058692,9622,1790
2024-2025,10,03,Capitale-Nationale,Total régional,Total régional,,320253,54791,17302,7.2269208051,263609,2.1073307879,213435,20987,6425,3.910329317,157573,2.5905479559,106818,17627,2373,13.853862934,106036,1.3892541081,33804,10877
2024-2025,10,12,Chaudière-Appalaches,Total régional,Total régional,,193498,31476,8289,6.3397265232,167791,2.0303184021,150774,15744,4264,3.627766814,125135,2.3927295254,42724,8462,2265,15.910296067,42656,0.9671545816,15732,4025
2024-2025,10,09,Côte-Nord,Total régional,Total régional,,80488,9632,4483,6.6134951345,64928,3.2288678742,63579,5543,2677,4.7066511523,48427,3.4372341761,16909,2688,792,13.783359322,16501,2.6173561535,4089,1806
2024-2025,10,05,Estrie,Total régional,Total régional,,192795,31897,9610,8.734723372,157058,3.7167457121,126723,11626,3488,5.9084715548,91467,4.8004243486,66072,11414,1620,14.155341925,65591,2.2055500628,20271,6122
2024-2025,10,11,Gaspésie-Îles-de-la-Madeleine,Total régional,Total régional,,82125,13744,3109,5.0372545003,72070,2.0482805451,66098,8616,1982,3.5571178192,56303,2.2090160481,16027,1772,277,11.141583092,15767,1.4743038202,5128,1127
2024-2025,10,14,Lanaudière,Total régional,Total régional,,122929,22536,7647,10.090000949,90428,3.5195333089,81070,7284,3953,5.7949583488,48767,4.4179230149,41859,12549,1657,18.40838179,41661,2.4679077888,15252,3694
2024-2025,10,15,Laurentides,Total régional,Total régional,,161934,29031,10442,11.809600166,123566,3.8709183621,105406,10481,3322,6.304972909,67475,4.8264395085,56528,18276,5918,22.073907071,56091,2.7214685511,18550,7120
2024-2025,10,13,Laval,Total régional,Total régional,,72780,14079,4774,10.803477795,56029,3.7701796094,45587,4271,1020,6.4820036901,28962,4.8479119958,27193,7138,760,18.048101043,27067,2.6169936126,9808,3754
2024-2025,10,04,Mauricie et Centre-du-Québec,Total régional,Total régional,,199365,35684,10047,7.308816576,156616,3.1992920051,129255,12429,3031,4.8553923124,87817,4.0055135648,70110,7884,488,11.831956687,68799,2.1702078801,23255,7016
2024-2025,10,06,Montréal,Total régional,Total régional,,717145,105145,50668,10.844276488,580102,2.774525762,442367,29153,17639,5.7041415675,308339,3.6366058426,274778,72606,21205,19.119415199,271763,1.7964201702,75992,33029
2024-2025,10,16,Montérégie,Total régional,Total régional,,300450,57350,19154,11.478701457,218489,4.0976961858,187306,19899,6918,6.169886398,106517,4.960543304,113144,33926,10383,20.267262171,111972,3.2768848537,37451,12236
2024-2025,10,07,Outaouais,Total régional,Total régional,,132709,18562,7263,9.5511779512,98984,4.2245284507,97832,8416,2958,5.5625353781,65307,4.085716526,34877,10119,3241,20.73955081,33677,4.4937148499,10146,4305
2024-2025,10,02,Saguenay-Lac-Saint-Jean,Total régional,Total régional,,148697,23905,7094,6.3502697973,126657,2.9299589157,102733,10307,2756,4.1557058156,81515,3.3203363764,45964,4213,283,11.255285495,45142,2.225036256,13598,4338
2020-2021,10,01,Bas-Saint-Laurent,CISSS DU BAS-SAINT-LAURENT,Total établissement,,77969,13566,3567,3.9011363419,68511,1.2921543499,56016,6060,2140,2.5232223432,46782,1.426781211,21953,281,0,7.4170672194,21729,1.0023060452,7506,1427
2020-2021,10,02,Saguenay-Lac-Saint-Jean,CIUSSS DU SAGUENAY - LAC-SAINT-JEAN,Total établissement,,104165,16192,5423,5.2142704977,92476,1.6899630805,67180,6023,1902,2.8070477986,55866,1.9036718716,36985,2162,148,9.5867788368,36610,1.3638484855,10169,3521
2020-2021,10,03,Capitale-Nationale,CHU DE QUÉBEC - UNIVERSITÉ LAVAL,Total établissement,,147056,24151,12546,9.0472840656,129579,1.4971730566,83306,6434,3486,3.7156847613,65983,1.9634442668,63750,13196,3115,16.014408954,63596,1.0134009127,17717,9060
2020-2021,10,03,Capitale-Nationale,CIUSSS DE LA CAPITALE-NATIONALE,Total établissement,,62855,7687,1531,3.3066311307,50814,1.306252132,51711,4488,986,2.2802752047,39775,1.4347588589,11144,503,65,8.0691841898,11039,0.8432251311,3199,545
2020-2021,10,03,Capitale-Nationale,INSTITUT UNIVERSITAIRE DE CARDIOLOGIE ET DE PNEUMOLOGIE DE QUÉBEC - UNIVERSITÉ LAVAL,Total établissement,,16980,5173,452,7.7058424126,16265,1.4432258257,8197,1568,256,3.6797963008,7490,1.8653341492,8783,643,0,11.463271535,8775,1.082930516,3605,196
2020-2021,10,04,Mauricie et Centre-du-Québec,CIUSSS DE LA MAURICIE-ET-DU-CENTRE-DU-QUÉBEC,Total établissement,,144684,24148,8834,6.1474011466,121804,1.8986657982,90947,7208,3018,3.2621679537,68549,2.3077664842,53737,4957,322,11.030504096,53255,1.3720778174,16940,5816
2020-2021,10,05,Estrie,CIUSSS DE L'ESTRIE - CENTRE HOSPITALIER UNIVERSITAIRE DE SHERBROOKE,Total établissement,,141788,21797,8722,7.4100887083,123771,2.0713325617,87473,6721,2959,3.9580519036,69716,2.5848538595,54315,8062,1494,12.969510883,54055,1.4090321124,15076,5763
2020-2021,10,06,Montréal,CENTRE HOSPITALIER DE L'UNIVERSITÉ DE MONTRÉAL,Total établissement,,39948,5791,3090,12.634029516,34971,2.1596798856,23605,1632,1304,5.8030229,18700,2.8882658942,16343,6147,1389,22.500388885,16271,1.3223276415,4159,1786
2020-2021,10,06,Montréal,CENTRE HOSPITALIER UNIVERSITAIRE SAINTE-JUSTINE,Total établissement,,36845,0,1131,4.1800083081,35429,1.0418488934,25154,0,548,3.3838972043,23839,1.1736981184,11691,24,0,5.8928967439,11590,0.7706535807,0,583
2020-2021,10,06,Montréal,CENTRE UNIVERSITAIRE DE SANTÉ MCGILL,Total établissement,,89027,9580,5067,9.7783807628,82476,1.6442718387,49978,2083,1361,4.6482707502,43752,1.9331357805,39049,7961,2478,16.344301483,38724,1.317901237,7497,3706
2020-2021,10,06,Montréal,CIUSSS DE L'EST-DE-L'ÎLE-DE-MONTRÉAL,Total établissement,,68091,13878,7796,13.925195873,58426,2.5901916765,37656,3099,2732,5.0936694388,28162,3.5021291003,30435,11976,4253,24.85208792,30264,1.7415932847,10779,5064
2020-2021,10,06,Montréal,CIUSSS DE L'OUEST-DE-L'ÎLE-DE-MONTRÉAL,Total établissement,,68350,11268,7875,10.307469223,64193,1.9630047452,43169,3116,2598,4.8637857027,39079,2.2875692685,25181,7316,1576,19.63983783,25114,1.4579614624,8152,5277
2020-2021,10,06,Montréal,CIUSSS DU CENTRE-OUEST-DE-L'ÎLE-DE-MONTRÉAL,Total établissement,,48962,8993,2694,8.3811567247,46280,1.1714990217,19311,1033,324,3.2845700925,16885,1.286535518,29651,3293,581,11.700443914,29395,1.1054200544,7960,2370
2020-2021,10,06,Montréal,CIUSSS DU CENTRE-SUD-DE-L'ÎLE-DE-MONTRÉAL,Total établissement,,48669,6701,5783,11.290796845,43636,1.6900962253,28034,1659,1978,4.1791951044,23507,2.1641375737,20635,7119,2067,20.952373933,20129,1.1365024067,5042,3805
2020-2021,10,06,Montréal,CIUSSS DU NORD-DE-L'ÎLE-DE-MONTRÉAL,Total établissement,,81906,12433,7436,9.5626613367,71965,2.0147847642,55016,3698,3271,4.5926186372,45132,2.5913228604,26890,7999,1937,19.731194961,26833,1.0450714502,8735,4165
2020-2021,10,06,Montréal,INSTITUT DE CARDIOLOGIE DE MONTRÉAL,Total établissement,,12313,3249,422,8.5567680049,12033,1.1443622169,7661,1430,363,3.1347002495,7384,1.2701821506,4652,1244,132,17.485929887,4649,0.9445225975,1819,59
2020-2021,10,07,Outaouais,CISSS DE L'OUTAOUAIS,Total établissement,,93919,12727,5980,7.7473214182,74170,2.2603798294,65535,5306,2578,3.6788234404,46214,2.2596736318,28384,6247,2019,17.140959206,27956,2.2615472429,7421,3402
2020-2021,10,08,Abitibi-Témiscamingue,CISSS DE L'ABITIBI-TÉMISCAMINGUE,Total établissement,,68497,8034,4318,5.1218858328,58995,2.0000127224,55169,4383,3231,3.7552498585,45713,2.2081815652,13328,1289,159,10.778844121,13282,1.2835526778,3651,1087
2020-2021,10,09,Côte-Nord,CISSS DE LA CÔTE-NORD,Total établissement,,58803,6740,3298,5.9502825205,47708,1.8788155376,45606,3531,2000,3.1240316272,35301,1.9334371705,13197,2280,1088,15.717199111,12407,1.7234034103,3209,1298
2020-2021,10,11,Gaspésie-Îles-de-la-Madeleine,CISSS DE LA GASPÉSIE,Total établissement,,46620,7940,2041,4.7751274727,42271,1.2904272235,35861,4294,1391,2.7035227065,31761,1.3859516475,10759,1304,375,11.680027419,10510,1.0017544138,3646,650
2020-2021,10,11,Gaspésie-Îles-de-la-Madeleine,CISSS DES ÎLES,Total établissement,,8420,965,243,3.4294638757,7204,0.768185653,6815,562,125,1.7967678324,5612,0.8046467886,1605,120,9,10.362064209,1592,0.6396555695,403,118
2020-2021,10,12,Chaudière-Appalaches,CISSS DE CHAUDIÈRE-APPALACHES,Total établissement,,112203,18966,5790,5.5906055839,97902,0.8938046692,77110,6803,2639,2.3980835747,62840,1.061569524,35093,4290,336,12.605547941,35062,0.5931274837,12163,3151
2020-2021,10,13,Laval,CISSS DE LAVAL,Total établissement,,55188,9619,3962,8.4389321602,44570,2.1566241057,34831,2618,1157,4.2474595746,24261,2.7222299049,20357,3887,294,15.610577374,20309,1.4809550774,7001,2805
2020-2021,10,14,Lanaudière,CISSS DE LANAUDIÈRE,Total établissement,,86834,13747,6036,9.3026577435,70995,2.4061374666,52972,3699,2946,4.7828007721,37380,3.0350236015,33862,7946,1040,16.373293367,33615,1.7068138397,10048,3090
2020-2021,10,15,Laurentides,CISSS DES LAURENTIDES,Total établissement,,116055,17631,8770,10.544531563,96892,2.7032869615,72241,5642,3136,5.0054306419,53338,3.3685096825,43814,11836,3620,19.677461441,43554,1.8886281589,11989,5634
2020-2021,10,16,Montérégie,CISSS DE LA MONTÉRÉGIE-CENTRE,Total établissement,,84887,14487,7201,9.5000364144,65766,2.275931138,54821,4386,2729,4.0254693761,35758,2.7193844268,30066,8877,2037,19.482117157,30008,1.7475052949,10101,4472
2020-2021,10,16,Montérégie,CISSS DE LA MONTÉRÉGIE-EST,Total établissement,,87422,15353,5558,9.3643018125,72623,2.1178235354,52853,5071,2087,3.9393661297,38197,2.5328206767,34569,9003,2353,17.658557523,34426,1.657367897,10282,3471
2020-2021,10,16,Montérégie,CISSS DE LA MONTÉRÉGIE-OUEST,Total établissement,,63198,10797,3995,11.348593244,54817,2.1438762407,41312,3064,2024,4.5729865751,32984,2.5724564941,21886,7596,3048,24.138224182,21833,1.4964026423,7733,1971
2021-2022,10,01,Bas-Saint-Laurent,CISSS DU BAS-SAINT-LAURENT,Total établissement,,100160,15745,4231,4.1017010339,87254,1.7591367572,75496,7747,2647,3.0132551504,62907,1.9496926592,24664,406,6,7.4334116413,24347,1.2667845114,7998,1584
2021-2022,10,02,Saguenay-Lac-Saint-Jean,CIUSSS DU SAGUENAY - LAC-SAINT-JEAN,Total établissement,,128271,18789,6443,5.9044215935,110189,2.3249537512,87354,7564,2393,3.4670489172,69907,2.6219812433,40917,4012,444,11.107986194,40282,1.8094803165,11225,4050
2021-2022,10,03,Capitale-Nationale,CHU DE QUÉBEC - UNIVERSITÉ LAVAL,Total établissement,,177917,27459,13534,8.5214254243,149849,1.7917141497,107046,8466,4020,4.0701309873,79174,2.4016779147,70871,13663,2786,15.244813895,70675,1.1083993829,18993,9514
2021-2022,10,03,Capitale-Nationale,CIUSSS DE LA CAPITALE-NATIONALE,Total établissement,,81352,9388,1732,3.7041376603,63539,1.8269762709,68762,5776,1090,2.9296236616,51067,2.0277133744,12590,446,29,7.9342513679,12472,1.0050518272,3612,642
2021-2022,10,03,Capitale-Nationale,INSTITUT UNIVERSITAIRE DE CARDIOLOGIE ET DE PNEUMOLOGIE DE QUÉBEC - UNIVERSITÉ LAVAL,Total établissement,,20645,6245,477,7.5875789807,19589,1.7630391348,10698,2109,273,3.878100268,9657,2.2157601567,9947,810,0,11.577123896,9932,1.3228531794,4136,204
2021-2022,10,04,Mauricie et Centre-du-Québec,CIUSSS DE LA MAURICIE-ET-DU-CENTRE-DU-QUÉBEC,Total établissement,,183517,29155,9918,6.9043878163,144565,2.9018505036,121632,9478,3499,4.3990518417,83650,3.5650907551,61885,7371,346,11.828505539,60915,1.9910724188,19677,6419
2021-2022,10,05,Estrie,CIUSSS DE L'ESTRIE - CENTRE HOSPITALIER UNIVERSITAIRE DE SHERBROOKE,Total établissement,,172904,25679,9552,8.0474830076,144132,2.8673927892,110691,8426,3490,4.826894345,82282,3.6665943037,62213,10441,2038,13.777638757,61850,1.8041769604,17253,6062
2021-2022,10,06,Montréal,CENTRE HOSPITALIER DE L'UNIVERSITÉ DE MONTRÉAL,Total établissement,,48543,7027,3877,13.321388855,39149,2.9683620768,29587,2129,1476,6.9970276454,20344,4.2657018722,18956,7207,1899,23.192610373,18805,1.5648480753,4898,2401
2021-2022,10,06,Montréal,CENTRE HOSPITALIER UNIVERSITAIRE SAINTE-JUSTINE,Total établissement,,63685,1,1747,5.2686936266,55583,1.9325915997,44252,1,888,4.5366185646,36734,2.2398278162,19433,256,0,6.9357437806,18849,1.3338322398,0,859
2021-2022,10,06,Montréal,CENTRE UNIVERSITAIRE DE SANTÉ MCGILL,Total établissement,,128731,11417,6376,10.119123819,111224,2.4810643611,84365,3087,1795,5.9010034671,67233,3.0039588364,44366,9847,3773,18.140169743,43991,1.6819062548,8330,4581
2021-2022,10,06,Montréal,CIUSSS DE L'EST-DE-L'ÎLE-DE-MONTRÉAL,Total établissement,,78674,15099,8606,12.764562954,61355,3.3089116481,44888,3464,2977,5.6055174793,27916,4.4807231615,33786,11875,3738,22.276053905,33439,2.33064405,11635,5629
2021-2022,10,06,Montréal,CIUSSS DE L'OUEST-DE-L'ÎLE-DE-MONTRÉAL,Total établissement,,79415,13448,8763,11.284374667,69299,2.6841988501,52780,4277,3513,6.0499487443,42753,3.2802129935,26635,8298,2731,21.656929583,26546,1.7243030965,9171,5250
2021-2022,10,06,Montréal,CIUSSS DU CENTRE-OUEST-DE-L'ÎLE-DE-MONTRÉAL,Total établissement,,65449,11378,3362,9.1144176764,59428,1.8809048531,27286,1615,467,4.0046146783,21941,2.1081554193,38163,5172,957,12.767853848,37487,1.7478959521,9763,2895
2021-2022,10,06,Montréal,CIUSSS DU CENTRE-SUD-DE-L'ÎLE-DE-MONTRÉAL,Total établissement,,56216,8164,6081,11.232716318,49063,2.1437174596,36713,2391,2587,4.8535445361,29637,2.7295839379,19503,7264,1988,23.241050095,19426,1.2498986181,5773,3494
2021-2022,10,06,Montréal,CIUSSS DU NORD-DE-L'ÎLE-DE-MONTRÉAL,Total établissement,,100663,15932,8028,10.19505129,81701,2.797314544,69452,5006,3645,5.5520120331,50566,3.7066808451,31211,10218,2459,20.526933079,31135,1.3204230591,10926,4383
2021-2022,10,06,Montréal,INSTITUT DE CARDIOLOGIE DE MONTRÉAL,Total établissement,,13767,3664,420,9.4433252625,13377,1.4588999568,8433,1462,357,3.5499502945,8046,1.6729105214,5334,1637,167,18.760691424,5331,1.1358969549,2202,63
2021-2022,10,07,Outaouais,CISSS DE L'OUTAOUAIS,Total établissement,,106256,13725,6799,8.108272576,82508,2.3268744849,77942,6327,3061,3.8671283027,54637,2.3401214633,28314,7271,3050,19.783177815,27871,2.3009057304,7398,3738
2021-2022,10,08,Abitibi-Témiscamingue,CISSS DE L'ABITIBI-TÉMISCAMINGUE,Total établissement,,83532,9048,4929,5.7681191207,68253,2.7095492302,68704,5046,3679,4.4212410566,53541,2.9993433122,14828,1858,270,12.008738929,14712,1.6549091445,4002,1250
2021-2022,10,09,Côte-Nord,CISSS DE LA CÔTE-NORD,Total établissement,,74378,8232,4188,6.7863776438,59732,2.434119958,58410,4448,2603,3.9168611349,44189,2.5251515586,15968,3035,1483,17.282899393,15543,2.1753156476,3784,1585
2021-2022,10,11,Gaspésie-Îles-de-la-Madeleine,CISSS DE LA GASPÉSIE,Total établissement,,59382,9617,2526,5.2008388532,52557,1.7492768222,47176,5581,1752,3.2101076112,40598,1.875693076,12206,1827,459,12.894984115,11959,1.3201232916,4036,774
2021-2022,10,11,Gaspésie-Îles-de-la-Madeleine,CISSS DES ÎLES,Total établissement,,12461,1529,374,3.4262521289,10899,1.1381401199,10431,1036,212,2.3222399046,8878,1.2119776414,2030,110,2,9.099134647,2021,0.8137811315,493,162
2021-2022,10,12,Chaudière-Appalaches,CISSS DE CHAUDIÈRE-APPALACHES,Total établissement,,156037,24103,7294,5.7630260024,135230,1.3642365723,114661,9856,3545,2.9490926635,93893,1.6127237358,41376,6476,643,13.560986428,41337,0.7998219983,14247,3749
2021-2022,10,13,Laval,CISSS DE LAVAL,Total établissement,,68609,11118,4352,8.4179448032,52927,2.819525363,45341,3309,1285,4.8783485942,29726,3.5863187763,23268,4106,291,15.315350326,23201,1.8370805976,7809,3067
2021-2022,10,14,Lanaudière,CISSS DE LANAUDIÈRE,Total établissement,,107879,17230,6869,9.9586079234,81061,3.3818738495,70906,5275,3685,5.8746073988,44287,4.3340616823,36973,10718,1302,17.790813619,36774,2.2351521833,11955,3184
2021-2022,10,15,Laurentides,CISSS DES LAURENTIDES,Total établissement,,139566,21817,9496,12.176760057,106664,3.6477130652,92042,7672,3519,6.1900899378,59489,4.5412885482,47524,17128,6329,23.771429932,47175,2.5208892834,14145,5977
2021-2022,10,16,Montérégie,CISSS DE LA MONTÉRÉGIE-CENTRE,Total établissement,,105579,16431,7822,9.5532082506,69045,3.6780323219,74921,6104,3339,5.2635870302,38460,4.344110295,30658,9674,2223,20.036041816,30585,2.8404531542,10327,4483
2021-2022,10,16,Montérégie,CISSS DE LA MONTÉRÉGIE-EST,Total établissement,,104598,18207,6044,10.520804214,79513,3.2497844692,64851,6258,2298,4.8897837607,40075,3.9423940875,39747,11446,4258,19.708348114,39438,2.5459878656,11949,3746
2021-2022,10,16,Montérégie,CISSS DE LA MONTÉRÉGIE-OUEST,Total établissement,,72181,12302,4218,13.094508697,58059,2.5584875443,48472,3765,2155,5.677849675,34444,3.1500413796,23709,8889,4030,28.257539448,23615,1.695668137,8537,2063
2022-2023,10,01,Bas-Saint-Laurent,CISSS DU BAS-SAINT-LAURENT,Total établissement,,110650,17182,3931,4.3766647211,94853,1.9670216575,83556,8074,2364,3.1819833372,68215,2.1410243145,27094,790,30,8.0609785069,26638,1.521432978,9108,1567
2022-2023,10,02,Saguenay-Lac-Saint-Jean,CIUSSS DU SAGUENAY - LAC-SAINT-JEAN,Total établissement,,141495,20243,6716,6.3270050964,119830,2.7258076117,98878,8139,2552,3.867773547,77903,3.0428698474,42617,4940,744,12.032800838,41927,2.1366860588,12104,4164
2022-2023,10,03,Capitale-Nationale,CHU DE QUÉBEC - UNIVERSITÉ LAVAL,Total établissement,,178684,28654,13345,9.2813812062,149660,1.9194585505,105958,8671,4213,4.2567557691,77214,2.5523843906,72726,15536,4176,16.60199917,72446,1.2448769888,19983,9132
2022-2023,10,03,Capitale-Nationale,CIUSSS DE LA CAPITALE-NATIONALE,Total établissement,,101263,11110,1840,3.9801954317,74936,2.0851531566,85897,6865,1164,3.1496945696,59821,2.3201335141,15366,828,140,8.6227525417,15115,1.1551657294,4245,676
2022-2023,10,03,Capitale-Nationale,INSTITUT UNIVERSITAIRE DE CARDIOLOGIE ET DE PNEUMOLOGIE DE QUÉBEC - UNIVERSITÉ LAVAL,Total établissement,,21296,6746,475,8.2392077412,20110,1.969325239,10892,2210,245,4.0281928378,9733,2.4903320034,10404,1148,1,12.647740452,10377,1.480652324,4536,230
2022-2023,10,04,Mauricie et Centre-du-Québec,CIUSSS DE LA MAURICIE-ET-DU-CENTRE-DU-QUÉBEC,Total établissement,,191426,30374,9452,7.8265514989,145851,3.2672510054,128460,9894,2928,4.8481492293,83896,4.0936547763,62966,10666,1445,13.902934873,61955,2.1481811844,20480,6524
2022-2023,10,05,Estrie,CIUSSS DE L'ESTRIE - CENTRE HOSPITALIER UNIVERSITAIRE DE SHERBROOKE,Total établissement,,186129,27634,9503,8.7879675595,149874,3.3651347873,122598,9162,3264,5.4201512826,86701,4.3762387945,63531,13014,3054,15.286960806,63173,1.9774576384,18472,6239
2022-2023,10,06,Montréal,CENTRE HOSPITALIER DE L'UNIVERSITÉ DE MONTRÉAL,Total établissement,,51714,7257,4215,13.970996249,39855,3.099965953,31077,1923,1573,7.4223675601,19373,4.9044656223,20637,8315,2331,23.832494226,20482,1.3931711042,5334,2642
2022-2023,10,06,Montréal,CENTRE HOSPITALIER UNIVERSITAIRE SAINTE-JUSTINE,Total établissement,,71823,0,1405,6.2520435384,56706,2.8824770062,48923,0,691,5.6270807073,34887,3.5955405149,22900,517,10,7.5871988476,21819,1.7423401241,0,714
2022-2023,10,06,Montréal,CENTRE UNIVERSITAIRE DE SANTÉ MCGILL,Total établissement,,136832,10970,5974,11.647353886,110612,2.973500326,93936,3110,1765,6.8833962988,68182,3.7066184501,42896,11486,5358,22.079727998,42430,1.7954315081,7860,4209
2022-2023,10,06,Montréal,CIUSSS DE L'EST-DE-L'ÎLE-DE-MONTRÉAL,Total établissement,,82251,16103,8063,13.499555473,61648,3.2196804663,49115,3974,2690,5.4616741944,28837,4.4693718236,33136,12674,5267,25.413502208,32811,2.1213491241,12129,5373
2022-2023,10,06,Montréal,CIUSSS DE L'OUEST-DE-L'ÎLE-DE-MONTRÉAL,Total établissement,,80125,14468,8724,12.069450123,67823,2.6747401406,54015,4562,3348,5.9853371851,41819,3.2676602807,26110,9160,3542,24.6559442,26004,1.7212203999,9906,5376
2022-2023,10,06,Montréal,CIUSSS DU CENTRE-OUEST-DE-L'ÎLE-DE-MONTRÉAL,Total établissement,,67632,12628,3612,10.293880781,59115,2.3226462639,26257,1625,426,4.1468640426,18806,2.7944938672,41375,6479,1616,14.194840745,40309,2.1025076837,11003,3186
2022-2023,10,06,Montréal,CIUSSS DU CENTRE-SUD-DE-L'ÎLE-DE-MONTRÉAL,Total établissement,,60193,8794,6236,10.934602353,52289,2.2201486238,38586,2255,2326,4.894400279,30753,2.9088055095,21607,7379,1771,21.72125655,21536,1.2367596376,6539,3910
2022-2023,10,06,Montréal,CIUSSS DU NORD-DE-L'ÎLE-DE-MONTRÉAL,Total établissement,,107976,16975,8413,10.78077759,83541,3.2648498176,76637,5514,3775,6.0429741509,52314,4.3204297394,31339,11812,3095,22.36669425,31227,1.4964568233,11461,4638
2022-2023,10,06,Montréal,INSTITUT DE CARDIOLOGIE DE MONTRÉAL,Total établissement,,14203,3976,432,9.135502828,13805,1.3009667592,8733,1624,366,3.6922737191,8342,1.5203072471,5470,1454,172,17.825762391,5463,0.9660338743,2352,66
2022-2023,10,07,Outaouais,CISSS DE L'OUTAOUAIS,Total établissement,,123076,15279,6649,8.932929247,90958,2.9527944918,92202,7066,2981,4.3970038279,60730,3.0020447793,30874,8731,4353,22.479000229,30228,2.8538474906,8213,3668
2022-2023,10,08,Abitibi-Témiscamingue,CISSS DE L'ABITIBI-TÉMISCAMINGUE,Total établissement,,88573,9515,4665,6.1392353012,73664,2.9833221678,73101,5126,3386,4.8048413496,58332,3.2749024025,15472,1977,327,12.44388449,15332,1.8739784257,4389,1279
2022-2023,10,09,Côte-Nord,CISSS DE LA CÔTE-NORD,Total établissement,,79298,8616,3844,6.6297825887,62998,2.8821519202,63126,4797,2491,4.4790077253,47209,3.0276770319,16172,2769,1107,15.025145811,15789,2.4470328499,3819,1353
2022-2023,10,11,Gaspésie-Îles-de-la-Madeleine,CISSS DE LA GASPÉSIE,Total établissement,,64845,10669,2698,5.6496911181,56738,1.9904025031,52251,6351,1824,3.5415379238,44416,2.1419321241,12594,2169,741,14.396166627,12322,1.4441973706,4318,874
2022-2023,10,11,Gaspésie-Îles-de-la-Madeleine,CISSS DES ÎLES,Total établissement,,13590,1658,364,4.4996154648,11893,1.9075550511,11539,1147,224,3.3338401652,9856,2.0301284046,2051,211,18,11.058309361,2037,1.3144853543,511,140
2022-2023,10,12,Chaudière-Appalaches,CISSS DE CHAUDIÈRE-APPALACHES,Total établissement,,189346,27968,7705,6.1142134549,161727,1.7637231226,147263,12875,4074,3.3751988921,119696,2.0656614047,42083,9251,1703,15.69897456,42031,0.9038624335,15093,3631
2022-2023,10,13,Laval,CISSS DE LAVAL,Total établissement,,72579,12180,4414,9.3561265885,53907,3.2350124546,48347,3474,1290,5.5735865261,29766,4.1724498216,24232,5611,454,16.902943376,24141,2.0791464728,8706,3124
2022-2023,10,14,Lanaudière,CISSS DE LANAUDIÈRE,Total établissement,,112852,18450,6678,10.980255709,79403,3.9712312297,76412,5753,3578,6.3709982471,43140,5.0448411503,36440,12350,3041,20.645529615,36263,2.6940194168,12697,3100
2022-2023,10,15,Laurentides,CISSS DES LAURENTIDES,Total établissement,,148760,23502,9396,12.370324533,109316,4.0680678339,99410,8189,3197,6.5595123199,60363,5.0308553759,49350,18157,6641,24.075549296,48953,2.880873088,15313,6199
2022-2023,10,16,Montérégie,CISSS DE LA MONTÉRÉGIE-CENTRE,Total établissement,,109654,16838,7436,10.092619175,67774,4.1542761318,78924,6257,2996,5.6216424345,37158,4.8046851134,30730,9734,3033,21.575449253,30616,3.36488833,10581,4440
2022-2023,10,16,Montérégie,CISSS DE LA MONTÉRÉGIE-EST,Total établissement,,106692,19209,6031,11.7691105,80643,4.0119741398,67124,6723,2253,5.8587947513,41386,4.8134308032,39568,12299,4935,21.795496326,39257,3.1670525851,12486,3778
2022-2023,10,16,Montérégie,CISSS DE LA MONTÉRÉGIE-OUEST,Total établissement,,75626,12984,3957,13.868663698,57971,2.5032399341,53283,4400,1877,5.9646505243,35685,3.0423525369,22343,9724,5111,32.717946871,22286,1.6399969463,8584,2080
2023-2024,10,01,Bas-Saint-Laurent,CISSS DU BAS-SAINT-LAURENT,Total établissement,,103919,18174,4232,4.7171102761,90398,1.9911029282,77382,8885,2475,3.3397644945,64310,2.1827970637,26537,1197,141,8.7334561807,26088,1.5185542523,9289,1757
2023-2024,10,02,Saguenay-Lac-Saint-Jean,CIUSSS DU SAGUENAY - LAC-SAINT-JEAN,Total établissement,,137282,21780,7025,6.1955981038,117463,2.6927780497,93467,9245,2794,3.8610818108,74398,3.0219408452,43815,4080,310,11.175633123,43065,2.1241247662,12535,4231
2023-2024,10,03,Capitale-Nationale,CHU DE QUÉBEC - UNIVERSITÉ LAVAL,Total établissement,,180333,31308,13712,9.1010187634,152429,2.0148502017,105422,9320,4324,4.3241016001,77900,2.682371559,74911,14977,3322,15.823558326,74529,1.3171363757,21988,9388
2023-2024,10,03,Capitale-Nationale,CIUSSS DE LA CAPITALE-NATIONALE,Total établissement,,92851,11150,1760,3.9444349011,70884,1.8980070256,78096,7063,1117,2.980301527,56356,2.1088469334,14755,966,219,9.0474481155,14528,1.0801316232,4087,643
2023-2024,10,03,Capitale-Nationale,INSTITUT UNIVERSITAIRE DE CARDIOLOGIE ET DE PNEUMOLOGIE DE QUÉBEC - UNIVERSITÉ LAVAL,Total établissement,,22286,7440,550,8.2175321826,20940,2.1370962008,11645,2571,314,4.1696222747,10328,2.7343844135,10641,1300,6,12.647370626,10612,1.5557927085,4869,236
2023-2024,10,04,Mauricie et Centre-du-Québec,CIUSSS DE LA MAURICIE-ET-DU-CENTRE-DU-QUÉBEC,Total établissement,,185265,32328,9344,7.4090562842,145790,3.0066325041,120865,10694,2926,4.5830796297,82485,3.7354556889,64400,8944,821,12.712808898,63305,2.0569921851,21634,6418
2023-2024,10,05,Estrie,CIUSSS DE L'ESTRIE - CENTRE HOSPITALIER UNIVERSITAIRE DE SHERBROOKE,Total établissement,,180832,29334,9635,8.7675239433,148960,3.3273229913,118137,10621,3431,5.39692103,86593,4.2769179187,62695,12681,2717,15.118794641,62367,2.0088649357,18713,6204
2023-2024,10,06,Montréal,CENTRE HOSPITALIER DE L'UNIVERSITÉ DE MONTRÉAL,Total établissement,,56673,8396,4327,12.828658709,42269,3.189006686,33350,2280,1338,7.5662190571,19128,5.2484011223,23323,7713,1354,20.353520964,23141,1.4867424461,6116,2989
2023-2024,10,06,Montréal,CENTRE HOSPITALIER UNIVERSITAIRE SAINTE-JUSTINE,Total établissement,,60283,0,1340,5.2433789054,52125,1.9502108766,38186,0,570,4.4457474962,30672,2.524775338,22097,351,4,6.6217720354,21453,1.1287387674,0,770
2023-2024,10,06,Montréal,CENTRE UNIVERSITAIRE DE SANTÉ MCGILL,Total établissement,,129546,11082,6093,11.443643689,111251,2.5001216918,86636,3317,1766,5.9019625053,68855,2.9098132872,42910,11764,5321,22.632389692,42396,1.8347448921,7765,4327
2023-2024,10,06,Montréal,CIUSSS DE L'EST-DE-L'ÎLE-DE-MONTRÉAL,Total établissement,,80747,15715,7941,12.430261485,62669,3.1027065526,47328,4025,2942,5.5796314256,29419,4.3648684052,33419,11572,3514,22.132126277,33250,1.9859685213,11690,4999
2023-2024,10,06,Montréal,CIUSSS DE L'OUEST-DE-L'ÎLE-DE-MONTRÉAL,Total établissement,,79164,15203,8951,13.10094559,67286,2.7893199551,52337,5023,3380,6.2613924184,40561,3.4452231824,26827,10322,4115,26.444282315,26725,1.7938441534,10180,5571
2023-2024,10,06,Montréal,CIUSSS DU CENTRE-OUEST-DE-L'ÎLE-DE-MONTRÉAL,Total établissement,,69057,13433,3803,11.225416134,59085,2.5864841424,24934,1681,400,4.1390847058,16241,3.1148900246,44123,7364,2134,15.229916912,42844,2.386179784,11752,3403
2023-2024,10,06,Montréal,CIUSSS DU CENTRE-SUD-DE-L'ÎLE-DE-MONTRÉAL,Total établissement,,62150,10009,6468,11.406573232,52791,2.272175997,38865,2745,2405,5.011500922,29576,3.0221500917,23285,8428,1890,22.080590211,23215,1.3167060928,7264,4063
2023-2024,10,06,Montréal,CIUSSS DU NORD-DE-L'ÎLE-DE-MONTRÉAL,Total établissement,,107495,17796,8134,11.05756614,81839,3.3584699091,75262,5957,3321,6.2177450366,49697,4.5051502326,32233,12018,3258,22.358239856,32142,1.5855070555,11839,4813
2023-2024,10,06,Montréal,INSTITUT DE CARDIOLOGIE DE MONTRÉAL,Total établissement,,15100,4180,388,8.66792695,14616,1.4991361065,9521,1881,325,3.9437373525,9041,1.7642443375,5579,1251,84,16.730126118,5575,1.0692090184,2299,63
2023-2024,10,07,Outaouais,CISSS DE L'OUTAOUAIS,Total établissement,,119384,16348,6551,9.7201379791,89151,3.460876774,87515,7531,2811,5.1227914135,58096,3.4234038153,31869,9548,4151,22.344844895,31055,3.530979141,8817,3740
2023-2024,10,08,Abitibi-Témiscamingue,CISSS DE L'ABITIBI-TÉMISCAMINGUE,Total établissement,,85446,10084,4464,6.214446512,72393,2.8517625054,68996,5481,3168,4.8492468404,56120,3.1397740803,16450,1852,334,11.940483992,16273,1.8585092894,4603,1296
2023-2024,10,09,Côte-Nord,CISSS DE LA CÔTE-NORD,Total établissement,,76884,8952,4078,6.2647569426,61413,2.7290657335,60650,5172,2588,3.9620339516,45552,2.8670426533,16234,2872,1026,14.867698264,15861,2.3328029093,3780,1490
2023-2024,10,11,Gaspésie-Îles-de-la-Madeleine,CISSS DE LA GASPÉSIE,Total établissement,,62352,10910,2602,5.6097282632,55565,1.877182254,49979,6555,1752,3.4208206391,43368,2.0159933143,12373,2337,588,14.451513937,12197,1.3836217011,4355,850
2023-2024,10,11,Gaspésie-Îles-de-la-Madeleine,CISSS DES ÎLES,Total établissement,,13045,1833,389,3.9923437247,11610,1.4929402574,10626,1185,229,2.8607443221,9214,1.5729477184,2419,131,0,8.9631478802,2396,1.1852654888,648,160
2023-2024,10,12,Chaudière-Appalaches,CISSS DE CHAUDIÈRE-APPALACHES,Total établissement,,182884,29157,7703,5.8901923836,158364,1.843515819,142632,14157,4080,3.401642278,118164,2.1686615965,40252,7265,1413,14.708310208,40200,0.8877813502,15000,3623
2023-2024,10,13,Laval,CISSS DE LAVAL,Total établissement,,69561,13493,4348,9.7876321342,54277,3.0068660093,44223,4116,1040,5.4492635619,28999,3.8419205739,25338,5831,653,17.359487583,25278,2.048888823,9377,3308
2023-2024,10,14,Lanaudière,CISSS DE LANAUDIÈRE,Total établissement,,112418,20234,7009,10.644304782,81322,4.0001600599,74147,6680,3706,6.2489507555,43272,5.0089437807,38271,11944,2079,19.159951486,38050,2.852930384,13554,3303
2023-2024,10,15,Laurentides,CISSS DES LAURENTIDES,Total établissement,,146324,25962,9925,11.993527915,110886,3.9769485728,95241,9331,3130,6.5450850007,60251,4.9697844572,51083,17296,5399,22.151802714,50635,2.7955650461,16631,6795
2023-2024,10,16,Montérégie,CISSS DE LA MONTÉRÉGIE-CENTRE,Total établissement,,105173,18747,7148,10.375787087,68060,4.4375649468,72506,7018,2598,5.9318663015,35607,5.2066991899,32667,10285,2570,20.239286045,32453,3.5936810841,11729,4550
2023-2024,10,16,Montérégie,CISSS DE LA MONTÉRÉGIE-EST,Total établissement,,109033,21217,5918,10.787767108,84408,4.0814205506,61785,7391,2062,5.765117275,37730,4.756191875,47248,11534,3164,17.35575771,46678,3.536000394,13826,3856
2023-2024,10,16,Montérégie,CISSS DE LA MONTÉRÉGIE-OUEST,Total établissement,,76565,14409,4483,13.591123493,60840,2.7064531558,52209,4999,2008,6.7186985322,36539,3.5149160106,24356,10122,4673,28.322706463,24301,1.4908478618,9410,2475
2024-2025,10,01,Bas-Saint-Laurent,CISSS DU BAS-SAINT-LAURENT,Total établissement,,115802,19738,4538,4.7545630689,100305,2.073975497,89295,10116,2748,3.3808992478,74180,2.2804149891,26507,1623,168,9.3820694219,26125,1.4878058692,9622,1790
2024-2025,10,02,Saguenay-Lac-Saint-Jean,CIUSSS DU SAGUENAY - LAC-SAINT-JEAN,Total établissement,,148697,23905,7094,6.3502697973,126657,2.9299589157,102733,10307,2756,4.1557058156,81515,3.3203363764,45964,4213,283,11.255285495,45142,2.225036256,13598,4338
2024-2025,10,03,Capitale-Nationale,CHU DE QUÉBEC - UNIVERSITÉ LAVAL,Total établissement,,192854,34184,14790,8.9107211788,162188,2.1758106505,112486,10044,4826,4.5362369045,82343,2.9086980847,80368,15554,2233,15.033409787,79845,1.4199943815,24140,9964
2024-2025,10,03,Capitale-Nationale,CIUSSS DE LA CAPITALE-NATIONALE,Total établissement,,103246,12470,2029,3.9170476392,78913,1.9685898887,88299,8066,1347,3.0878595769,64188,2.1674716025,14947,884,140,8.8154537886,14725,1.1016411998,4404,682
2024-2025,10,03,Capitale-Nationale,INSTITUT UNIVERSITAIRE DE CARDIOLOGIE ET DE PNEUMOLOGIE DE QUÉBEC - UNIVERSITÉ LAVAL,Total établissement,,24153,8137,483,7.9309131716,22508,2.1003043362,12650,2877,252,4.0856190162,11042,2.6773971603,11503,1189,0,12.159633598,11466,1.5445517666,5260,231
2024-2025,10,04,Mauricie et Centre-du-Québec,CIUSSS DE LA MAURICIE-ET-DU-CENTRE-DU-QUÉBEC,Total établissement,,199365,35684,10047,7.308816576,156616,3.1992920051,129255,12429,3031,4.8553923124,87817,4.0055135648,70110,7884,488,11.831956687,68799,2.1702078801,23255,7016
2024-2025,10,05,Estrie,CIUSSS DE L'ESTRIE - CENTRE HOSPITALIER UNIVERSITAIRE DE SHERBROOKE,Total établissement,,192795,31897,9610,8.734723372,157058,3.7167457121,126723,11626,3488,5.9084715548,91467,4.8004243486,66072,11414,1620,14.155341925,65591,2.2055500628,20271,6122
2024-2025,10,06,Montréal,CENTRE HOSPITALIER DE L'UNIVERSITÉ DE MONTRÉAL,Total établissement,,61999,9248,5296,12.052487782,44445,3.2263127773,37250,2628,1892,7.6363475391,19875,5.3032500908,24749,7347,767,18.699270442,24570,1.5462505427,6620,3404
2024-2025,10,06,Montréal,CENTRE HOSPITALIER UNIVERSITAIRE SAINTE-JUSTINE,Total établissement,,64544,1,1550,5.0811233121,55070,1.8059714202,41282,0,575,4.2870562567,32376,2.3470254458,23262,363,7,6.4903175422,22694,1.0340861143,1,975
2024-2025,10,06,Montréal,CENTRE UNIVERSITAIRE DE SANTÉ MCGILL,Total établissement,,140924,12675,6909,11.477701363,120268,2.5245462033,94699,3657,1919,5.9566611991,74502,3.021705081,46225,12808,6123,22.78839866,45766,1.7152263871,9018,4990
2024-2025,10,06,Montréal,CIUSSS DE L'EST-DE-L'ÎLE-DE-MONTRÉAL,Total établissement,,89314,17487,8315,12.78472318,65033,3.4345355691,52659,4499,3117,5.4640554954,28668,4.916919184,36655,13136,4407,23.301679656,36365,2.265912622,12988,5198
2024-2025,10,06,Montréal,CIUSSS DE L'OUEST-DE-L'ÎLE-DE-MONTRÉAL,Total établissement,,86968,17025,9321,12.106318365,72815,3.0919965361,56134,5233,3464,6.471691988,42103,3.9475413272,30834,10190,2924,22.364284151,30712,1.9191324329,11792,5857
2024-2025,10,06,Montréal,CIUSSS DU CENTRE-OUEST-DE-L'ÎLE-DE-MONTRÉAL,Total établissement,,75772,14418,3917,11.003781234,65230,2.5401301165,26654,1707,385,3.7601962078,17310,2.9217360229,49118,8117,2658,14.934529947,47920,2.4022837426,12711,3532
2024-2025,10,06,Montréal,CIUSSS DU CENTRE-SUD-DE-L'ÎLE-DE-MONTRÉAL,Total établissement,,66125,10851,6536,10.694267948,55556,2.3242162063,42331,3024,2583,5.3327210621,31833,3.1345044189,23794,7339,1314,20.232791997,23723,1.2369209792,7827,3953
2024-2025,10,06,Montréal,CIUSSS DU NORD-DE-L'ÎLE-DE-MONTRÉAL,Total établissement,,115359,19028,8435,10.65460301,86086,3.4211556144,80652,6216,3356,5.9785145095,51505,4.6271003355,34707,12361,2953,21.52088041,34581,1.6250195033,12812,5079
2024-2025,10,06,Montréal,INSTITUT DE CARDIOLOGIE DE MONTRÉAL,Total établissement,,16140,4412,389,7.4026314884,15599,1.6158201559,10706,2189,348,3.6096990525,10167,1.8647232604,5434,945,52,14.875420347,5432,1.1499516241,2223,41
2024-2025,10,07,Outaouais,CISSS DE L'OUTAOUAIS,Total établissement,,132709,18562,7263,9.5511779512,98984,4.2245284507,97832,8416,2958,5.5625353781,65307,4.085716526,34877,10119,3241,20.73955081,33677,4.4937148499,10146,4305
2024-2025,10,08,Abitibi-Témiscamingue,CISSS DE L'ABITIBI-TÉMISCAMINGUE,Total établissement,,94059,11491,4972,6.3457381744,78815,3.2285270676,76420,6413,3627,5.1014176699,61385,3.5620126117,17639,2063,287,11.736688509,17430,2.0540571811,5078,1345
2024-2025,10,09,Côte-Nord,CISSS DE LA CÔTE-NORD,Total établissement,,80488,9632,4483,6.6134951345,64928,3.2288678742,63579,5543,2677,4.7066511523,48427,3.4372341761,16909,2688,792,13.783359322,16501,2.6173561535,4089,1806
2024-2025,10,11,Gaspésie-Îles-de-la-Madeleine,CISSS DE LA GASPÉSIE,Total établissement,,69366,11820,2726,5.067592076,61120,2.0714930965,55805,7364,1790,3.5886464624,47784,2.2394918627,13561,1509,219,11.153615228,13336,1.4695395088,4456,936
2024-2025,10,11,Gaspésie-Îles-de-la-Madeleine,CISSS DES ÎLES,Total établissement,,12759,1924,383,4.8723202358,10950,1.9187142314,10293,1252,192,3.3861806837,8519,2.0380738806,2466,263,58,11.075416103,2431,1.5004399196,672,191
2024-2025,10,12,Chaudière-Appalaches,CISSS DE CHAUDIÈRE-APPALACHES,Total établissement,,193498,31476,8289,6.3397265232,167791,2.0303184021,150774,15744,4264,3.627766814,125135,2.3927295254,42724,8462,2265,15.910296067,42656,0.9671545816,15732,4025
2024-2025,10,13,Laval,CISSS DE LAVAL,Total établissement,,72780,14079,4774,10.803477795,56029,3.7701796094,45587,4271,1020,6.4820036901,28962,4.8479119958,27193,7138,760,18.048101043,27067,2.6169936126,9808,3754
2024-2025,10,14,Lanaudière,CISSS DE LANAUDIÈRE,Total établissement,,122929,22536,7647,10.090000949,90428,3.5195333089,81070,7284,3953,5.7949583488,48767,4.4179230149,41859,12549,1657,18.40838179,41661,2.4679077888,15252,3694
2024-2025,10,15,Laurentides,CISSS DES LAURENTIDES,Total établissement,,161934,29031,10442,11.809600166,123566,3.8709183621,105406,10481,3322,6.304972909,67475,4.8264395085,56528,18276,5918,22.073907071,56091,2.7214685511,18550,7120
2024-2025,10,16,Montérégie,CISSS DE LA MONTÉRÉGIE-CENTRE,Total établissement,,108045,20173,7808,11.465415046,69669,5.0339539465,74288,7716,2721,6.5596956328,36006,6.0951026835,33757,12268,3218,22.261282088,33663,3.8989475174,12457,5087
2024-2025,10,16,Montérégie,CISSS DE LA MONTÉRÉGIE-EST,Total établissement,,113412,23104,6455,10.834693198,85226,4.5767743021,62429,7934,2158,5.9326162076,34796,5.4230333388,50983,11879,2852,16.837316905,50430,3.9928673133,15170,4297
2024-2025,10,16,Montérégie,CISSS DE LA MONTÉRÉGIE-OUEST,Total établissement,,78993,14073,4891,12.421491261,63594,2.4299593952,50589,4249,2039,5.8902681468,35715,3.3661502403,28404,9779,4313,24.053939019,27879,1.230631728,9824,2852
2020-2021,10,01,Bas-Saint-Laurent,CISSS DU BAS-SAINT-LAURENT,CENTRE HOSPITALIER RÉGIONAL DU GRAND-PORTAGE,51218352,11999,2304,671,4.8322300701,10226,1.5117833627,8048,779,375,2.6829123178,6297,1.7511061264,3951,86,0,9.2102886049,3929,1.1282212749,1525,296
2020-2021,10,01,Bas-Saint-Laurent,CISSS DU BAS-SAINT-LAURENT,CENTRE MULTISERVICES DE SANTÉ ET DE SERVICES SOCIAUX DE TROIS-PISTOLES,51236156,4990,744,168,2.9326489646,4490,1.0663755877,4163,461,132,2.2143856594,3675,1.1706274376,827,14,0,6.5482839581,815,0.5962828903,283,36
2020-2021,10,01,Bas-Saint-Laurent,CISSS DU BAS-SAINT-LAURENT,CLSC DE POHÉNÉGAMOOK,51219418,4952,749,140,1.3976733867,4272,0.5585575323,4599,631,127,1.0463545819,3925,0.5673506723,353,0,0,5.9747702235,347,0.4590962216,118,13
2020-2021,10,01,Bas-Saint-Laurent,CISSS DU BAS-SAINT-LAURENT,HÔPITAL D'AMQUI,51226892,8582,1337,282,3.7082133471,7988,1.087063964,4982,493,165,2.5446908314,4469,1.1962308869,3600,15,0,5.3183992284,3519,0.9484260049,844,117
2020-2021,10,01,Bas-Saint-Laurent,CISSS DU BAS-SAINT-LAURENT,HÔPITAL DE MATANE,51218980,11099,1982,562,4.0414996096,9932,1.7186393028,8251,956,315,3.1793606499,7131,1.9459693591,2848,53,0,6.5392203105,2801,1.1398850609,1026,247
2020-2021,10,01,Bas-Saint-Laurent,CISSS DU BAS-SAINT-LAURENT,HÔPITAL DE NOTRE-DAME-DU-LAC,51221877,7305,1256,232,3.3114085102,6726,0.8489586018,5501,651,113,1.7105312165,4934,0.9756851552,1804,35,0,8.1930193705,1792,0.5000362723,605,119
2020-2021,10,01,Bas-Saint-Laurent,CISSS DU BAS-SAINT-LAURENT,HÔPITAL NOTRE-DAME-DE-FATIMA,51221141,8943,1518,269,3.6589735609,8336,1.0785231726,6836,738,127,2.2814853147,6242,1.1590953754,2107,8,0,8.1281285925,2094,0.8383456702,780,142
2020-2021,10,01,Bas-Saint-Laurent,CISSS DU BAS-SAINT-LAURENT,HÔPITAL RÉGIONAL DE RIMOUSKI,51227882,20099,3676,1243,4.5294812207,16541,1.5379631589,13636,1351,786,3.0655362236,10109,1.7727063892,6463,70,0,7.6181945089,6432,1.1690235887,2325,457
2020-2021,10,02,Saguenay-Lac-Saint-Jean,CIUSSS DU SAGUENAY - LAC-SAINT-JEAN,HÔPITAL D'ALMA,51219400,18351,2775,813,4.1598489789,15355,1.809805239,13267,1331,319,2.7272240019,10343,1.9427579576,5084,119,11,7.8983689571,5012,1.5354377272,1444,494
2020-2021,10,02,Saguenay-Lac-Saint-Jean,CIUSSS DU SAGUENAY - LAC-SAINT-JEAN,HÔPITAL DE CHICOUTIMI,51218394,33032,5124,2109,6.3375103856,29901,1.345209051,16931,1264,605,2.3310424993,13929,1.5725102903,16101,1452,74,10.550510061,15972,1.1469822189,3860,1504
2020-2021,10,02,Saguenay-Lac-Saint-Jean,CIUSSS DU SAGUENAY - LAC-SAINT-JEAN,HÔPITAL DE DOLBEAU-MISTASSINI,51219384,11279,1902,443,4.4435476697,10315,1.4532975979,9051,1059,203,2.6933503051,8097,1.5677907455,2228,251,58,11.553528077,2218,1.035330503,843,240
2020-2021,10,02,Saguenay-Lac-Saint-Jean,CIUSSS DU SAGUENAY - LAC-SAINT-JEAN,HÔPITAL DE LA BAIE,51221364,9632,1403,324,4.4852498327,8853,1.7992142651,7284,636,177,2.9722925438,6522,2.0352483475,2348,66,1,9.1787681005,2331,1.1388048763,767,147
2020-2021,10,02,Saguenay-Lac-Saint-Jean,CIUSSS DU SAGUENAY - LAC-SAINT-JEAN,HÔPITAL ET CENTRE D'HÉBERGEMENT DE ROBERVAL,51228203,15112,2139,977,4.1583215877,13867,1.6000568296,10127,794,289,2.6484016052,8926,1.7866857122,4985,87,1,7.2257157027,4941,1.2629085992,1345,688
2020-2021,10,02,Saguenay-Lac-Saint-Jean,CIUSSS DU SAGUENAY - LAC-SAINT-JEAN,HÔPITAL ET CENTRE DE RÉADAPTATION DE JONQUIÈRE,51224541,16759,2849,757,6.0448235774,14185,2.478757412,10520,939,309,3.8099291033,8049,2.7875317845,6239,187,3,9.8132303521,6136,2.073717496,1910,448
2020-2021,10,03,Capitale-Nationale,CHU DE QUÉBEC - UNIVERSITÉ LAVAL,CENTRE HOSPITALIER DE L'UNIVERSITÉ LAVAL,51217594,47187,4575,4879,7.6510671195,41172,1.5037528201,26242,832,1332,4.0289371787,20271,2.0924623436,20945,2464,553,12.189235365,20901,0.9327882371,3743,3547
2020-2021,10,03,Capitale-Nationale,CHU DE QUÉBEC - UNIVERSITÉ LAVAL,HÔPITAL DE L'ENFANT-JÉSUS,51233914,40572,6482,5469,10.5756052,36931,1.3639666992,22080,1846,1276,3.5961418705,18451,1.7903804521,18492,4755,1485,18.909292757,18480,0.938222102,4636,4193
2020-2021,10,03,Capitale-Nationale,CHU DE QUÉBEC - UNIVERSITÉ LAVAL,HÔPITAL DU SAINT-SACREMENT,51217529,20237,4214,653,7.5669339851,17391,1.5251713051,14160,1526,270,3.0732618291,11325,1.8307222222,6077,1596,377,18.037626387,6066,0.9547189252,2688,383
2020-2021,10,03,Capitale-Nationale,CHU DE QUÉBEC - UNIVERSITÉ LAVAL,HÔPITAL SAINT-FRANÇOIS D'ASSISE,51217602,26917,5986,921,10.581433924,22988,1.7283309649,15170,1542,374,4.0821295686,11272,2.3031306679,11747,3530,669,18.974593631,11716,1.1753143849,4444,547
2020-2021,10,03,Capitale-Nationale,CHU DE QUÉBEC - UNIVERSITÉ LAVAL,L'HÔTEL-DIEU DE QUÉBEC,51217586,12143,2894,624,8.4328870314,11097,1.393340167,5654,688,234,3.3543260917,4664,1.5886601868,6489,851,31,12.857942287,6433,1.2517308755,2206,390
2020-2021,10,03,Capitale-Nationale,CIUSSS DE LA CAPITALE-NATIONALE,CENTRE MULTISERVICES DE SANTÉ ET DE SERVICES SOCIAUX CHAUVEAU,51225001,18537,1230,320,2.4352300055,14758,1.2537523904,16307,1027,255,2.1805063436,12549,1.3122205621,2230,0,0,4.2979110613,2209,0.9216034153,203,65
2020-2021,10,03,Capitale-Nationale,CIUSSS DE LA CAPITALE-NATIONALE,CENTRE MULTISERVICES DE SANTÉ ET DE SERVICES SOCIAUX DE BAIE-SAINT-PAUL,51244804,6938,1328,216,4.0712587281,5498,1.3098699527,5237,727,82,2.3501772643,3813,1.4919424046,1701,76,3,9.3700850807,1685,0.8978567425,601,134
2020-2021,10,03,Capitale-Nationale,CIUSSS DE LA CAPITALE-NATIONALE,CENTRE MULTISERVICES DE SANTÉ ET DE SERVICES SOCIAUX DE SAINT-MARC-DES-CARRIÈRES,51247344,8826,1263,251,2.8953615895,7495,1.1528652435,6994,667,154,1.9723095987,5684,1.3161232309,1832,26,0,6.4192838731,1811,0.6404641389,596,97
2020-2021,10,03,Capitale-Nationale,CIUSSS DE LA CAPITALE-NATIONALE,CENTRE MULTISERVICES DE SANTÉ ET DE SERVICES SOCIAUX DE SAINT-RAYMOND,51247302,11269,1550,259,3.7002932578,9532,1.6848755945,8737,720,161,2.676907755,7029,1.9208726941,2532,58,0,7.2316199315,2503,1.0221414303,830,98
2020-2021,10,03,Capitale-Nationale,CIUSSS DE LA CAPITALE-NATIONALE,CENTRE MULTISERVICES DE SANTÉ ET DE SERVICES SOCIAUX DE SAINTE-ANNE-DE-BEAUPRÉ,51225357,8938,995,171,2.8344515925,6554,1.1290162496,7812,606,137,2.12595423,5441,1.197070902,1126,36,2,7.7498880008,1113,0.7963249975,389,34
2020-2021,10,03,Capitale-Nationale,CIUSSS DE LA CAPITALE-NATIONALE,HÔPITAL ET CLSC DE LA MALBAIE,51228690,8347,1321,314,5.0152933522,6977,1.2284393563,6624,741,197,2.4546323973,5259,1.4101121886,1723,307,60,14.85964516,1718,0.6723174557,580,117
2020-2021,10,03,Capitale-Nationale,INSTITUT UNIVERSITAIRE DE CARDIOLOGIE ET DE PNEUMOLOGIE DE QUÉBEC - UNIVERSITÉ LAVAL,INSTITUT UNIVERSITAIRE DE CARDIOLOGIE ET DE PNEUMOLOGIE DE QUÉBEC,51232130,16980,5173,452,7.7058424126,16265,1.4432258257,8197,1568,256,3.6797963008,7490,1.8653341492,8783,643,0,11.463271535,8775,1.082930516,3605,196
2020-2021,10,04,Mauricie et Centre-du-Québec,CIUSSS DE LA MAURICIE-ET-DU-CENTRE-DU-QUÉBEC,CENTRE MULTISERVICES DE SANTÉ ET DE SERVICES SOCIAUX AVELLIN-DALCOURT,51233583,12215,1744,331,4.5168315368,10907,2.2930333985,10045,891,211,3.4275911177,8744,2.5501518502,2170,76,3,9.5589605735,2163,1.2536234397,853,120
2020-2021,10,04,Mauricie et Centre-du-Québec,CIUSSS DE LA MAURICIE-ET-DU-CENTRE-DU-QUÉBEC,CENTRE MULTISERVICES DE SANTÉ ET DE SERVICES SOCIAUX CHRIST-ROI,51246338,11128,1229,388,3.8372156822,9484,1.923369769,9210,599,251,2.4428564966,7581,2.0263504155,1918,159,18,10.532756923,1903,1.5131247446,630,137
2020-2021,10,04,Mauricie et Centre-du-Québec,CIUSSS DE LA MAURICIE-ET-DU-CENTRE-DU-QUÉBEC,CENTRE MULTISERVICES DE SANTÉ ET DE SERVICES SOCIAUX DE FORTIERVILLE,51219160,6529,638,169,1.59746941,5942,0.805739276,6035,518,158,1.4634495535,5448,0.8330090553,494,0,0,3.2347362798,494,0.5049988754,120,11
2020-2021,10,04,Mauricie et Centre-du-Québec,CIUSSS DE LA MAURICIE-ET-DU-CENTRE-DU-QUÉBEC,CENTRE MULTISERVICES DE SANTÉ ET DE SERVICES SOCIAUX DU HAUT-SAINT-MAURICE,51219731,7596,1161,429,4.0224076268,6519,1.8217447717,5677,609,222,2.7499770027,4623,1.9937026822,1919,49,0,7.7866539286,1896,1.4024613221,552,207
2020-2021,10,04,Mauricie et Centre-du-Québec,CIUSSS DE LA MAURICIE-ET-DU-CENTRE-DU-QUÉBEC,HÔPITAL DU CENTRE-DE-LA-MAURICIE,51220051,21343,4010,1611,5.7757066459,17730,1.7111391552,11822,913,346,3.0794713012,8280,2.2440734031,9521,308,2,9.123558158,9450,1.2441872428,3097,1265
2020-2021,10,04,Mauricie et Centre-du-Québec,CIUSSS DE LA MAURICIE-ET-DU-CENTRE-DU-QUÉBEC,HÔPITAL SAINTE-CROIX,51228781,25964,3773,1879,6.8147056715,22187,2.0725687089,15733,996,779,4.194574479,12081,2.5565209144,10231,812,36,10.843884056,10106,1.49403847,2777,1100
2020-2021,10,04,Mauricie et Centre-du-Québec,CIUSSS DE LA MAURICIE-ET-DU-CENTRE-DU-QUÉBEC,HÔTEL-DIEU D'ARTHABASKA,51228039,21950,3647,1287,4.8599795621,17954,1.5723622405,12371,1021,296,2.6689126227,8499,1.9560306114,9579,238,8,7.6896788113,9455,1.2274867795,2626,991
2020-2021,10,04,Mauricie et Centre-du-Québec,CIUSSS DE LA MAURICIE-ET-DU-CENTRE-DU-QUÉBEC,PAVILLON SAINTE-MARIE,51220168,37959,7946,2740,9.0542003653,31081,2.1491363516,20054,1661,755,3.9840491783,13293,3.0609427894,17905,3315,255,14.732882963,17788,1.4677419859,6285,1985
2020-2021,10,05,Estrie,CIUSSS DE L'ESTRIE - CENTRE HOSPITALIER UNIVERSITAIRE DE SHERBROOKE,CENTRE DE SANTÉ ET DE SERVICES SOCIAUX DU GRANIT,51223832,9077,1259,372,6.5370157174,7879,3.0561568374,7018,629,225,4.7814760061,5828,3.3477112408,2059,268,23,12.520686282,2051,2.2276931307,630,147
2020-2021,10,05,Estrie,CIUSSS DE L'ESTRIE - CENTRE HOSPITALIER UNIVERSITAIRE DE SHERBROOKE,CENTRE MULTISERVICES DE SANTÉ ET DE SERVICES SOCIAUX DE LA MRC DE COATICOOK,51247617,8652,653,303,2.8742809948,7641,1.5847658465,6547,344,212,2.1581663782,5576,1.6502620357,2105,17,1,5.101550541,2065,1.4079102771,309,91
2020-2021,10,05,Estrie,CIUSSS DE L'ESTRIE - CENTRE HOSPITALIER UNIVERSITAIRE DE SHERBROOKE,CENTRE MULTISERVICES DE SANTÉ ET DE SERVICES SOCIAUX DE MEMPHRÉMAGOG,51219046,13690,2665,508,6.2712066797,11409,2.6050263681,9276,1023,221,3.7528491986,7114,2.7851251835,4414,519,46,11.563522945,4295,2.30672067,1642,287
2020-2021,10,05,Estrie,CIUSSS DE L'ESTRIE - CENTRE HOSPITALIER UNIVERSITAIRE DE SHERBROOKE,CENTRE MULTISERVICES DE SANTÉ ET DE SERVICES SOCIAUX DES SOURCES,51247583,9750,1201,365,3.7806081197,7875,2.1404047619,8410,751,256,2.9163444643,6544,2.2776903355,1340,80,4,9.2048300166,1331,1.4654259538,450,109
2020-2021,10,05,Estrie,CIUSSS DE L'ESTRIE - CENTRE HOSPITALIER UNIVERSITAIRE DE SHERBROOKE,CHUS - HÔPITAL FLEURIMONT,51216687,28216,4032,630,7.3771943814,25895,1.6972542962,14324,702,270,4.6119310249,12007,2.6260500819,13892,1108,62,10.228449227,13888,0.8942552323,3330,360
2020-2021,10,05,Estrie,CIUSSS DE L'ESTRIE - CENTRE HOSPITALIER UNIVERSITAIRE DE SHERBROOKE,CHUS - HÔTEL-DIEU DE SHERBROOKE,51216695,30999,5641,4283,9.2415174683,27421,1.7864434801,13842,1167,841,4.0257103983,10288,2.5138770088,17157,2717,581,13.449549261,17133,1.3496352069,4474,3442
2020-2021,10,05,Estrie,CIUSSS DE L'ESTRIE - CENTRE HOSPITALIER UNIVERSITAIRE DE SHERBROOKE,HÔPITAL BROME-MISSISQUOI-PERKINS,51229185,17021,2587,541,8.1966128443,14867,2.2784704939,11882,883,264,4.0882372262,9756,2.563008519,5139,1257,399,17.695682526,5111,1.735337453,1704,277
2020-2021,10,05,Estrie,CIUSSS DE L'ESTRIE - CENTRE HOSPITALIER UNIVERSITAIRE DE SHERBROOKE,HÔPITAL DE GRANBY,51228120,24383,3759,1720,8.5959838594,20784,2.2515072224,16174,1222,670,4.2560440281,12603,2.7276285188,8209,2096,378,17.146865432,8181,1.5180325008,2537,1050
2020-2021,10,06,Montréal,CENTRE HOSPITALIER DE L'UNIVERSITÉ DE MONTRÉAL,CENTRE HOSPITALIER DE L'UNIVERSITÉ DE MONTRÉAL,51236297,39948,5791,3090,12.634029516,34971,2.1596798856,23605,1632,1304,5.8030229,18700,2.8882658942,16343,6147,1389,22.500388885,16271,1.3223276415,4159,1786
2020-2021,10,06,Montréal,CENTRE HOSPITALIER UNIVERSITAIRE SAINTE-JUSTINE,CHU SAINTE-JUSTINE,51222800,36845,0,1131,4.1800083081,35429,1.0418488934,25154,0,548,3.3838972043,23839,1.1736981184,11691,24,0,5.8928967439,11590,0.7706535807,0,583
2020-2021,10,06,Montréal,CENTRE UNIVERSITAIRE DE SANTÉ MCGILL,HÔPITAL DE LACHINE,51228310,10085,1794,493,9.7597493527,9312,2.0426403207,5845,555,134,3.8233758673,5199,2.1704342181,4240,1013,282,17.943264216,4113,1.8811036146,1239,359
2020-2021,10,06,Montréal,CENTRE UNIVERSITAIRE DE SANTÉ MCGILL,HÔPITAL GÉNÉRAL DE MONTRÉAL,51248219,18900,3278,2419,12.603855482,17471,1.2073265856,5389,403,339,4.5298529412,4102,1.7101696327,13511,2585,718,15.824253653,13369,1.0530396398,2875,2080
2020-2021,10,06,Montréal,CENTRE UNIVERSITAIRE DE SANTÉ MCGILL,HÔPITAL ROYAL VICTORIA,51223295,29827,4505,873,13.171968193,25954,2.5838210124,17999,1125,417,6.171201147,14162,3.1521800711,11828,4237,1473,23.825232147,11792,1.901231037,3380,456
2020-2021,10,06,Montréal,CENTRE UNIVERSITAIRE DE SANTÉ MCGILL,L'HÔPITAL DE MONTRÉAL POUR ENFANTS,51223279,30215,3,1282,4.667207283,29739,0.9562595974,20745,0,471,3.5901092633,20289,1.0664980613,9470,126,5,7.0267002523,9450,0.7195793651,3,811
2020-2021,10,06,Montréal,CIUSSS DE L'EST-DE-L'ÎLE-DE-MONTRÉAL,HÔPITAL MAISONNEUVE-ROSEMONT,12934659,42010,8059,3664,13.618968658,34775,2.6491544452,22754,1704,915,5.1340960686,15664,3.6217282552,19256,7184,2273,23.645183392,19111,1.8520011744,6355,2749
2020-2021,10,06,Montréal,CIUSSS DE L'EST-DE-L'ÎLE-DE-MONTRÉAL,HÔPITAL SANTA CABRINI,51235919,23012,5679,1076,14.227787736,20692,2.6876111541,13493,1360,415,5.1802451065,11199,3.5789642676,9519,4065,1694,27.052505953,9493,1.6360717546,4319,661
2020-2021,10,06,Montréal,CIUSSS DE L'EST-DE-L'ÎLE-DE-MONTRÉAL,INSTITUT UNIVERSITAIRE EN SANTÉ MENTALE DE MONTRÉAL,51235307,3069,140,3056,15.848089769,2959,1.2159996808,1409,35,1402,3.6117439476,1299,1.3975269438,1660,727,286,26.234241131,1660,1.0739491299,105,1654
2020-2021,10,06,Montréal,CIUSSS DE L'OUEST-DE-L'ÎLE-DE-MONTRÉAL,CENTRE HOSPITALIER DE ST. MARY,51248243,22963,4089,1919,8.6007396198,22299,1.4500657603,15019,1257,664,4.1226146696,14363,1.631855578,7944,1878,197,17.06712414,7936,1.1210527624,2832,1255
2020-2021,10,06,Montréal,CIUSSS DE L'OUEST-DE-L'ÎLE-DE-MONTRÉAL,HÔPITAL DE LASALLE,51224392,17296,2219,619,8.1912192286,15513,2.7716457344,12640,712,244,5.1299946159,10880,3.1866630923,4656,1233,57,16.501760273,4633,1.7970312612,1507,375
2020-2021,10,06,Montréal,CIUSSS DE L'OUEST-DE-L'ÎLE-DE-MONTRÉAL,HÔPITAL DOUGLAS,51235190,4026,113,3869,12.670158553,3699,2.5868714517,1583,35,1448,3.8196181652,1259,2.3275339776,2443,650,86,18.405076864,2440,2.720685337,78,2421
2020-2021,10,06,Montréal,CIUSSS DE L'OUEST-DE-L'ÎLE-DE-MONTRÉAL,HÔPITAL GÉNÉRAL DU LAKESHORE,51228278,24065,4847,1468,13.06176403,22682,1.8124843243,13927,1112,242,5.5401470365,12577,2.2546170037,10138,3555,1236,23.394527876,10105,1.2621921216,3735,1226
2020-2021,10,06,Montréal,CIUSSS DU CENTRE-OUEST-DE-L'ÎLE-DE-MONTRÉAL,HÔPITAL GÉNÉRAL JUIF,51248250,48962,8993,2694,8.3811567247,46280,1.1714990217,19311,1033,324,3.2845700925,16885,1.286535518,29651,3293,581,11.700443914,29395,1.1054200544,7960,2370
2020-2021,10,06,Montréal,CIUSSS DU CENTRE-SUD-DE-L'ÎLE-DE-MONTRÉAL,HÔPITAL DE VERDUN,51218097,24675,3633,2025,10.001257008,22326,1.3762970677,14417,971,608,3.4902312471,12383,1.7515598222,10258,3394,821,19.152110819,9943,0.9089452937,2662,1417
2020-2021,10,06,Montréal,CIUSSS DU CENTRE-SUD-DE-L'ÎLE-DE-MONTRÉAL,HÔPITAL NOTRE-DAME,51236313,23994,3068,3758,12.616936526,21310,2.0188564315,13617,688,1370,4.9086356515,11124,2.623410344,10377,3725,1246,22.731992226,10186,1.358630855,2380,2388
2020-2021,10,06,Montréal,CIUSSS DU NORD-DE-L'ÎLE-DE-MONTRÉAL,HÔPITAL DU SACRÉ-COEUR-DE-MONTRÉAL,12475976,35478,6406,1952,11.052616614,32276,1.6998313418,22078,1715,893,4.7328623894,18900,2.275075632,13400,4348,1496,21.465119133,13376,0.8870235455,4691,1059
2020-2021,10,06,Montréal,CIUSSS DU NORD-DE-L'ÎLE-DE-MONTRÉAL,HÔPITAL EN SANTÉ MENTALE ALBERT-PRÉVOST,51848752,2342,86,2339,17.827396575,2318,0.3270383952,938,29,935,3.4006340322,914,0.4732202772,1404,635,200,27.465789213,1404,0.2318744065,57,1404
2020-2021,10,06,Montréal,CIUSSS DU NORD-DE-L'ÎLE-DE-MONTRÉAL,HÔPITAL FLEURY,51228492,20095,3018,1040,8.0451494291,16786,2.4973706594,14856,1154,513,4.345340547,11565,2.9332205649,5239,1542,131,18.536533425,5221,1.5319226308,1864,527
2020-2021,10,06,Montréal,CIUSSS DU NORD-DE-L'ÎLE-DE-MONTRÉAL,HÔPITAL JEAN-TALON,51228500,23991,2923,2105,7.8235824545,20585,2.3051391925,17144,800,930,4.6915070708,13753,2.8791852485,6847,1474,110,15.665893011,6832,1.1495690216,2123,1175
2020-2021,10,06,Montréal,INSTITUT DE CARDIOLOGIE DE MONTRÉAL,INSTITUT DE CARDIOLOGIE DE MONTRÉAL,51248201,12313,3249,422,8.5567680049,12033,1.1443622169,7661,1430,363,3.1347002495,7384,1.2701821506,4652,1244,132,17.485929887,4649,0.9445225975,1819,59
2020-2021,10,07,Outaouais,CISSS DE L'OUTAOUAIS,CENTRE MULTISERVICES DE SANTÉ ET DE SERVICES SOCIAUX DE MANSFIELD-ET-PONTEFRACT,51245058,5735,651,202,4.1233093577,4759,1.602718008,5524,605,198,3.9517090574,4549,1.6132461957,211,8,1,8.615821485,210,1.3746574074,46,4
2020-2021,10,07,Outaouais,CISSS DE L'OUTAOUAIS,CLSC ET CENTRE D'HÉBERGEMENT DE LA PETITE-NATION,51219491,5835,756,227,2.4561174902,4922,0.8542183056,5226,591,200,2.2316088362,4316,0.8948083359,609,3,0,4.3826892903,606,0.5651315548,165,27
2020-2021,10,07,Outaouais,CISSS DE L'OUTAOUAIS,HÔPITAL DE GATINEAU,51221703,23819,3195,3085,10.286562536,17368,2.6430011292,13814,973,847,3.8200751251,7501,2.7795294701,10005,2600,893,19.214904076,9867,2.5392108093,2222,2238
2020-2021,10,07,Outaouais,CISSS DE L'OUTAOUAIS,HÔPITAL DE HULL,51221711,20812,3784,874,10.726532449,15601,2.3489756355,12144,948,514,3.9933765188,7038,2.6610084936,8668,2395,882,20.159786443,8563,2.0925132677,2836,360
2020-2021,10,07,Outaouais,CISSS DE L'OUTAOUAIS,HÔPITAL DE MANIWAKI,51221893,9232,1132,480,4.962119891,7644,2.078913745,6395,501,236,3.1901659282,4893,2.2371429139,2837,163,59,8.956355207,2751,1.7974832384,631,244
2020-2021,10,07,Outaouais,CISSS DE L'OUTAOUAIS,HÔPITAL ET CHSLD DE PAPINEAU,51228823,13584,1642,652,7.4966977081,10726,2.984558627,9580,548,231,3.8266340466,6801,3.0055637651,4004,833,141,16.277719156,3925,2.9481622081,1094,421
2020-2021,10,07,Outaouais,CISSS DE L'OUTAOUAIS,HÔPITAL ET CHSLD DU PONTIAC,51219459,6369,805,205,4.7081965597,5844,1.7149753784,5609,636,151,4.0323736158,5088,1.7503124454,760,36,0,9.6959477339,756,1.4771513081,169,54
2020-2021,10,07,Outaouais,CISSS DE L'OUTAOUAIS,HÔPITAL ET CHSLD MÉMORIAL DE WAKEFIELD / WAKEFIELD MEMORIAL HOSPITAL,51228799,8533,762,255,5.1276096071,7306,2.1002810475,7243,504,201,3.6802615552,6028,2.2159439283,1290,209,43,13.254076227,1278,1.5547287428,258,54
2020-2021,10,08,Abitibi-Témiscamingue,CISSS DE L'ABITIBI-TÉMISCAMINGUE,CENTRE MULTISERVICES DE SANTÉ ET DE SERVICES SOCIAUX DE LA SARRE,51247559,10689,1328,590,3.7894624796,9989,1.213118764,9050,813,519,3.1480399632,8354,1.2612002234,1639,44,0,7.3311792421,1635,0.9674475025,515,71
2020-2021,10,08,Abitibi-Témiscamingue,CISSS DE L'ABITIBI-TÉMISCAMINGUE,CENTRE MULTISERVICES DE SANTÉ ET DE SERVICES SOCIAUX DE TÉMISCAMING-KIPAWA,51247476,3024,273,174,2.5639065256,2796,0.7130697624,3002,265,172,2.4888814864,2774,0.7132086638,22,3,0,12.801414141,22,0.6955555556,8,2
2020-2021,10,08,Abitibi-Témiscamingue,CISSS DE L'ABITIBI-TÉMISCAMINGUE,CENTRE MULTISERVICES DE SANTÉ ET DE SERVICES SOCIAUX DE VILLE-MARIE,51247542,7695,1071,437,4.2227996174,6894,2.0107533121,6790,800,355,3.5922524546,5994,2.0753560968,905,23,0,8.9536451811,900,1.5804987654,271,82
2020-2021,10,08,Abitibi-Témiscamingue,CISSS DE L'ABITIBI-TÉMISCAMINGUE,HÔPITAL D'AMOS,51228906,11832,1240,569,4.0851865938,10364,0.7717584105,8559,451,454,1.85554345,7096,0.8830592352,3273,295,47,9.9157749431,3268,0.5300844043,789,115
2020-2021,10,08,Abitibi-Témiscamingue,CISSS DE L'ABITIBI-TÉMISCAMINGUE,HÔPITAL DE ROUYN-NORANDA,51228922,16440,2096,1037,5.4496053832,13353,2.5616377926,12924,1014,665,4.3045007566,9857,2.8930434096,3516,211,6,9.6587442327,3496,1.627237001,1082,372
2020-2021,10,08,Abitibi-Témiscamingue,CISSS DE L'ABITIBI-TÉMISCAMINGUE,HÔPITAL DE VAL-D'OR,51225589,18817,2026,1511,7.0230702438,15599,3.0651309201,14844,1040,1066,5.0732711683,11638,3.5405993059,3973,713,106,14.307947535,3961,1.6681349407,986,445
2020-2021,10,09,Côte-Nord,CISSS DE LA CÔTE-NORD,CENTRE MULTISERVICES DE SANTÉ ET DE SERVICES SOCIAUX DE FERMONT,51245108,2916,7,180,5.3530086877,2518,1.4167410202,2797,7,172,5.3660461606,2399,1.4320641703,119,0,0,5.046573296,119,1.1078314659,0,8
2020-2021,10,09,Côte-Nord,CISSS DE LA CÔTE-NORD,CENTRE MULTISERVICES DE SANTÉ ET DE SERVICES SOCIAUX DE FORESTVILLE,51218741,6591,874,269,2.6432935484,5279,1.2305426112,5593,612,215,1.9932725431,4435,1.2997505324,998,33,4,6.2861467379,844,0.8668730253,262,54
2020-2021,10,09,Côte-Nord,CISSS DE LA CÔTE-NORD,CENTRE MULTISERVICES DE SANTÉ ET DE SERVICES SOCIAUX DE LA BASSE-CÔTE-NORD,51245140,2178,312,90,3.3153142536,2136,1.1578559353,1849,210,81,3.0959272279,1810,1.1837691835,329,2,0,4.5482826748,326,1.0139817655,102,9
2020-2021,10,09,Côte-Nord,CISSS DE LA CÔTE-NORD,CENTRE MULTISERVICES DE SANTÉ ET DE SERVICES SOCIAUX DE LA MINGANIE,51245116,7336,565,234,2.4243439507,2797,1.6457891392,5560,385,124,1.7716669664,1540,1.8158585859,1776,1,1,4.4676345095,1257,1.4374303898,180,110
2020-2021,10,09,Côte-Nord,CISSS DE LA CÔTE-NORD,CENTRE MULTISERVICES DE SANTÉ ET DE SERVICES SOCIAUX DE PORT-CARTIER,51245132,7457,596,338,3.8797509052,6772,1.3519835762,6678,405,275,2.3972248012,5996,1.4301804907,779,125,38,16.588748752,776,0.7477713345,191,63
2020-2021,10,09,Côte-Nord,CISSS DE LA CÔTE-NORD,CENTRE MULTISERVICES DE SANTÉ ET DE SERVICES SOCIAUX DES ESCOUMINS,51218733,5686,925,201,2.7608265916,5250,0.9145296296,4952,614,174,2.1706832256,4518,0.9431012985,734,9,0,6.742284287,732,0.7381815422,311,27
2020-2021,10,09,Côte-Nord,CISSS DE LA CÔTE-NORD,CLSC ET HÔPITAL LE ROYER,51228765,13257,1931,976,10.219258023,12149,2.5483012548,9458,733,572,4.464592526,8355,2.903738214,3799,1171,666,24.546087786,3794,1.7655717361,1198,404
2020-2021,10,09,Côte-Nord,CISSS DE LA CÔTE-NORD,HÔPITAL ET CLSC DE SEPT-ÎLES,51232023,13382,1530,1010,8.3508693892,10807,2.5519076113,8719,565,387,3.6424518293,6248,2.7234761346,4663,939,379,17.154792337,4559,2.316777071,965,623
2020-2021,10,11,Gaspésie-Îles-de-la-Madeleine,CISSS DE LA GASPÉSIE,CENTRE MULTISERVICES DE SANTÉ ET DE SERVICES SOCIAUX DE GRANDE-VALLÉE,51247732,3342,644,71,1.685254505,2581,0.7539708984,2981,513,63,1.285606247,2269,0.7776519269,361,5,0,4.9853970452,312,0.5817521368,131,8
2020-2021,10,11,Gaspésie-Îles-de-la-Madeleine,CISSS DE LA GASPÉSIE,CLSC ET CENTRE DE SERVICES AMBULATOIRES DE MURDOCHVILLE,51221307,1059,132,68,2.9909175323,1011,1.9796411694,1054,130,68,2.9811698819,1006,1.9849784626,5,0,0,5.0457222222,5,0.9057777778,2,0
2020-2021,10,11,Gaspésie-Îles-de-la-Madeleine,CISSS DE LA GASPÉSIE,CLSC ET CENTRE DE SERVICES AMBULATOIRES DE PASPÉBIAC,51220978,7108,1288,289,3.4285515147,6563,1.3526050502,5149,775,234,2.5959182473,4762,1.442333345,1959,49,8,5.6170296637,1801,1.1153556666,513,55
2020-2021,10,11,Gaspésie-Îles-de-la-Madeleine,CISSS DE LA GASPÉSIE,HÔPITAL DE CHANDLER,51227775,9028,1524,345,4.6028478991,8103,1.2979537071,7261,834,265,2.8772071493,6345,1.4174042553,1767,168,14,11.693893448,1758,0.8668309948,690,80
2020-2021,10,11,Gaspésie-Îles-de-la-Madeleine,CISSS DE LA GASPÉSIE,HÔPITAL DE GASPÉ,51220903,8102,1352,379,3.9339635961,7507,0.9338598049,6325,739,297,2.6364214317,5734,1.0382618785,1777,43,0,8.552395892,1773,0.5962165507,613,82
2020-2021,10,11,Gaspésie-Îles-de-la-Madeleine,CISSS DE LA GASPÉSIE,HÔPITAL ET CLSC DE SAINTE-ANNE-DES-MONTS,51247799,8539,1315,419,4.350378915,7796,1.028401602,6664,683,268,1.9850142974,5935,1.0912256389,1875,250,106,12.757200148,1861,0.8280465998,632,151
2020-2021,10,11,Gaspésie-Îles-de-la-Madeleine,CISSS DE LA GASPÉSIE,HÔPITAL ET GROUPE DE MÉDECINE DE FAMILLE UNIVERSITAIRE DE MARIA,51227908,9442,1685,470,8.3532542835,8710,1.8573895267,6427,620,196,4.0166792438,5710,2.0956550885,3015,789,247,17.597422701,3000,1.4038907407,1065,274
2020-2021,10,11,Gaspésie-Îles-de-la-Madeleine,CISSS DES ÎLES,HÔPITAL DE L'ARCHIPEL,51227783,8420,965,243,3.4294638757,7204,0.768185653,6815,562,125,1.7967678324,5612,0.8046467886,1605,120,9,10.362064209,1592,0.6396555695,403,118
2020-2021,10,12,Chaudière-Appalaches,CISSS DE CHAUDIÈRE-APPALACHES,CHSLD ET HÔPITAL PAUL-GILBERT,51245199,28,1,1,0.8799702381,17,0.3811601307,28,1,1,0.8799702381,17,0.3811601307,0,0,0,,0,,0,0
2020-2021,10,12,Chaudière-Appalaches,CISSS DE CHAUDIÈRE-APPALACHES,HÔPITAL DE MONTMAGNY,51245223,18519,2958,692,4.0965987184,17226,0.8936978985,13471,1277,345,1.9262036143,12182,1.0391920684,5048,215,0,9.8884751937,5044,0.5423081329,1681,347
2020-2021,10,12,Chaudière-Appalaches,CISSS DE CHAUDIÈRE-APPALACHES,HÔPITAL DE SAINT-GEORGES,51228971,24665,4207,1301,5.6950286055,21382,1.3516453351,16193,1368,526,2.7627139127,12929,1.6170629549,8472,650,9,11.299723107,8453,0.9456847996,2839,775
2020-2021,10,12,Chaudière-Appalaches,CISSS DE CHAUDIÈRE-APPALACHES,HÔPITAL DE THETFORD,51245231,20837,3508,712,4.8463693723,17622,0.7854754631,15378,1579,317,2.5491719773,12166,0.8737479908,5459,455,11,11.317573172,5456,0.588641964,1929,395
2020-2021,10,12,Chaudière-Appalaches,CISSS DE CHAUDIÈRE-APPALACHES,HÔTEL-DIEU DE LÉVIS,51227569,48154,8292,3084,6.4364640182,41655,0.704871344,32040,2578,1450,2.3410082189,25546,0.8810023639,16114,2970,316,14.579594452,16109,0.4255589698,5714,1634
2020-2021,10,13,Laval,CISSS DE LAVAL,HÔPITAL DE LA CITÉ-DE-LA-SANTÉ,51228757,55188,9619,3962,8.4389321602,44570,2.1566241057,34831,2618,1157,4.2474595746,24261,2.7222299049,20357,3887,294,15.610577374,20309,1.4809550774,7001,2805
2020-2021,10,14,Lanaudière,CISSS DE LANAUDIÈRE,HÔPITAL DE LANAUDIÈRE ET CENTRE D'HÉBERGEMENT PARPHILIA-FERLAND,51244945,39440,6283,3026,8.9474596856,35933,1.5893732549,23193,1395,1998,4.4059993676,19781,1.9531425077,16247,3493,439,15.430508196,16152,1.1438730326,4888,1028
2020-2021,10,14,Lanaudière,CISSS DE LANAUDIÈRE,HÔPITAL PIERRE-LE GARDEUR,51228062,47394,7464,3010,9.5982439233,35062,3.2431914973,29779,2304,948,5.0762678118,17599,4.251040984,17615,4453,601,17.242860819,17463,2.2274929852,5160,2062
2020-2021,10,15,Laurentides,CISSS DES LAURENTIDES,CENTRE MULTISERVICES DE SANTÉ ET DE SERVICES SOCIAUX D'ARGENTEUIL,51245306,11720,1359,583,6.8943654958,10460,2.4960332484,9606,752,367,4.2959681449,8349,2.7202462371,2114,572,99,18.701463392,2111,1.609271409,607,216
2020-2021,10,15,Laurentides,CISSS DES LAURENTIDES,CENTRE MULTISERVICES DE SANTÉ ET DE SERVICES SOCIAUX DE RIVIÈRE-ROUGE,51217628,8604,984,518,5.2343979867,7977,1.7555064909,6162,435,214,2.7990474774,5572,1.8574541358,2442,276,62,11.379619051,2405,1.5193101178,549,304
2020-2021,10,15,Laurentides,CISSS DES LAURENTIDES,CENTRE MULTISERVICES DE SANTÉ ET DE SERVICES SOCIAUX DE SAINTE-AGATHE,51246874,19728,2985,1284,10.195209389,16402,3.7022783807,12739,1081,366,6.1262171939,9485,4.6340482048,6989,1588,300,17.611848619,6917,2.4245804218,1904,918
2020-2021,10,15,Laurentides,CISSS DES LAURENTIDES,HÔPITAL DE MONT-LAURIER,51217610,11060,1392,624,6.868379998,9834,2.3389693919,8319,676,347,4.2420533317,7126,2.5131107135,2741,473,123,14.839343711,2708,1.8807230634,716,277
2020-2021,10,15,Laurentides,CISSS DES LAURENTIDES,HÔPITAL DE SAINT-EUSTACHE,51228864,30797,5509,2055,10.735984746,25354,2.2788550788,16629,1199,688,4.8659192275,11211,3.3253549341,14168,3679,683,17.625688269,14143,1.4493061939,4310,1367
2020-2021,10,15,Laurentides,CISSS DES LAURENTIDES,HÔPITAL DE SAINT-JÉRÔME,51228880,34146,5402,3706,14.355279999,26865,2.9894066836,18786,1499,1154,5.7934430486,11595,4.0936240477,15360,5248,2353,24.826807925,15270,2.1509390781,3903,2552
2020-2021,10,16,Montérégie,CISSS DE LA MONTÉRÉGIE-CENTRE,HÔPITAL CHARLES-LE MOYNE,51233799,45530,8535,4313,9.7416288589,32388,2.6811916279,29040,2655,1778,4.1962328206,15910,3.2045305887,16490,4975,817,19.507444562,16478,2.1758922671,5880,2535
2020-2021,10,16,Montérégie,CISSS DE LA MONTÉRÉGIE-CENTRE,HÔPITAL DU HAUT-RICHELIEU,51229045,39357,5952,2888,9.2205510879,33378,1.8826907777,25781,1731,951,3.833119567,19848,2.3304950961,13576,3902,1220,19.451353389,13530,1.2257787222,4221,1937
2020-2021,10,16,Montérégie,CISSS DE LA MONTÉRÉGIE-EST,HÔPITAL HONORÉ-MERCIER,51229193,30126,5204,2035,8.5412947565,24639,2.1393896194,21845,2053,1058,3.8734667226,16366,2.5372060301,8281,2911,635,20.854868407,8273,1.3524122984,3151,977
2020-2021,10,16,Montérégie,CISSS DE LA MONTÉRÉGIE-EST,HÔPITAL PIERRE-BOUCHER,51229011,36106,6652,2336,11.283870025,29074,2.4348007575,18172,1848,710,4.1400562832,11245,2.9491849464,17934,4809,1578,18.522488476,17829,2.1103714454,4804,1626
2020-2021,10,16,Montérégie,CISSS DE LA MONTÉRÉGIE-EST,HÔTEL-DIEU DE SOREL,51229102,21190,3497,1187,7.2635930208,18910,1.6023733768,12836,1170,319,3.7673990902,10586,2.0837571111,8354,1283,140,12.635528057,8324,0.9901763308,2327,868
2020-2021,10,16,Montérégie,CISSS DE LA MONTÉRÉGIE-OUEST,HÔPITAL ANNA-LABERGE,51229151,27686,4850,1738,11.753076164,23304,2.3906453947,17483,1296,523,5.5127228355,13105,3.0939323413,10203,3665,1047,22.446019145,10199,1.4869709721,3554,1215
2020-2021,10,16,Montérégie,CISSS DE LA MONTÉRÉGIE-OUEST,HÔPITAL BARRIE MEMORIAL / BARRIE MEMORIAL HOSPITAL,51228005,11046,1064,287,5.2763994508,9774,2.2147747425,9157,568,233,3.2605673559,7890,1.858264681,1889,375,43,15.048222899,1884,3.7078025478,496,54
2020-2021,10,16,Montérégie,CISSS DE LA MONTÉRÉGIE-OUEST,HÔPITAL DU SUROÎT,51229136,24466,4883,1970,13.632372306,21739,1.8474656276,14672,1200,1268,4.2723059418,11989,2.4724508577,9794,3556,1958,27.654313667,9750,1.0789581481,3683,702
2021-2022,10,01,Bas-Saint-Laurent,CISSS DU BAS-SAINT-LAURENT,CENTRE HOSPITALIER RÉGIONAL DU GRAND-PORTAGE,51218352,15345,2555,740,5.027789327,12970,2.171849803,10995,1023,451,3.2281928149,8643,2.46087926,4350,78,0,9.5764246488,4327,1.5945256529,1532,289
2021-2022,10,01,Bas-Saint-Laurent,CISSS DU BAS-SAINT-LAURENT,CENTRE MULTISERVICES DE SANTÉ ET DE SERVICES SOCIAUX DE TROIS-PISTOLES,51236156,7455,1091,218,3.332333147,6735,1.4702489483,6512,726,189,2.6788129607,5808,1.5816676232,943,40,2,7.8452954519,927,0.7721694834,365,29
2021-2022,10,01,Bas-Saint-Laurent,CISSS DU BAS-SAINT-LAURENT,CLSC DE POHÉNÉGAMOOK,51219418,6580,805,182,1.4878408055,5909,0.659786954,6189,697,169,1.2205558697,5523,0.6690816686,391,3,0,5.7185990338,386,0.5267954807,108,13
2021-2022,10,01,Bas-Saint-Laurent,CISSS DU BAS-SAINT-LAURENT,HÔPITAL D'AMQUI,51226892,11224,1697,387,3.7311932516,10085,1.5360236325,6450,623,224,2.941986348,5466,1.7656214681,4774,18,1,4.7974656705,4619,1.2643237473,1074,163
2021-2022,10,01,Bas-Saint-Laurent,CISSS DU BAS-SAINT-LAURENT,HÔPITAL DE MATANE,51218980,13259,2100,623,4.4659479305,11740,2.3685168228,10194,1096,376,3.9123240523,8723,2.6751294789,3065,42,0,6.3072666304,3017,1.4820129452,1004,247
2021-2022,10,01,Bas-Saint-Laurent,CISSS DU BAS-SAINT-LAURENT,HÔPITAL DE NOTRE-DAME-DU-LAC,51221877,9944,1563,279,3.4348135392,8858,1.2592000013,7855,879,140,2.19921324,6786,1.4250507172,2089,44,0,8.0808835966,2072,0.7160228979,684,139
2021-2022,10,01,Bas-Saint-Laurent,CISSS DU BAS-SAINT-LAURENT,HÔPITAL NOTRE-DAME-DE-FATIMA,51221141,11227,1766,390,3.4663182259,10494,1.3545990831,9105,922,237,2.5937519373,8387,1.4529483129,2122,3,0,7.210293748,2107,0.9631159363,844,153
2021-2022,10,01,Bas-Saint-Laurent,CISSS DU BAS-SAINT-LAURENT,HÔPITAL RÉGIONAL DE RIMOUSKI,51227882,25126,4168,1412,4.9700451723,20463,2.0943007705,18196,1781,861,3.6957191599,13571,2.4799911576,6930,178,3,8.3160244108,6892,1.334839911,2387,551
2021-2022,10,02,Saguenay-Lac-Saint-Jean,CIUSSS DU SAGUENAY - LAC-SAINT-JEAN,HÔPITAL D'ALMA,51219400,24418,3436,932,4.5790632366,19266,2.2479851523,18570,1781,419,3.1687818165,13530,2.4017958446,5848,276,25,9.0573337513,5736,1.8851785507,1655,513
2021-2022,10,02,Saguenay-Lac-Saint-Jean,CIUSSS DU SAGUENAY - LAC-SAINT-JEAN,HÔPITAL DE CHICOUTIMI,51218394,40201,6020,2473,7.1778287715,34992,2.0936304489,22819,1719,745,3.3366094166,17795,2.7036545066,17382,2350,245,12.22056174,17197,1.4623937153,4301,1728
2021-2022,10,02,Saguenay-Lac-Saint-Jean,CIUSSS DU SAGUENAY - LAC-SAINT-JEAN,HÔPITAL DE DOLBEAU-MISTASSINI,51219384,14162,2146,558,4.2582953208,12912,1.8119612462,11665,1297,261,3.0514970948,10434,1.9476441069,2497,203,45,9.8959810662,2478,1.2406476998,849,297
2021-2022,10,02,Saguenay-Lac-Saint-Jean,CIUSSS DU SAGUENAY - LAC-SAINT-JEAN,HÔPITAL DE LA BAIE,51221364,12525,1618,406,4.9517043469,11294,2.3246684818,9908,809,253,3.5529257783,8710,2.5700949738,2617,178,13,10.247500318,2584,1.4973988433,809,153
2021-2022,10,02,Saguenay-Lac-Saint-Jean,CIUSSS DU SAGUENAY - LAC-SAINT-JEAN,HÔPITAL ET CENTRE D'HÉBERGEMENT DE ROBERVAL,51228203,17430,2373,1185,5.6228136514,15771,2.2329638084,11846,871,356,3.4037393541,10289,2.4338998499,5584,473,97,10.330398559,5482,1.8558330293,1502,829
2021-2022,10,02,Saguenay-Lac-Saint-Jean,CIUSSS DU SAGUENAY - LAC-SAINT-JEAN,HÔPITAL ET CENTRE DE RÉADAPTATION DE JONQUIÈRE,51224541,19535,3196,889,6.9960012513,15954,3.4315788273,12546,1087,359,4.524105204,9149,3.8187093307,6989,532,19,11.433318151,6805,2.9111002123,2109,530
2021-2022,10,03,Capitale-Nationale,CHU DE QUÉBEC - UNIVERSITÉ LAVAL,CENTRE HOSPITALIER DE L'UNIVERSITÉ LAVAL,51217594,59335,4531,5407,7.3761629355,48197,1.7829037596,34985,916,1702,4.4166073952,23923,2.5905708477,24350,2483,519,11.62832107,24274,0.9869154697,3615,3705
2021-2022,10,03,Capitale-Nationale,CHU DE QUÉBEC - UNIVERSITÉ LAVAL,HÔPITAL DE L'ENFANT-JÉSUS,51233914,46252,7228,5573,9.6551517292,41208,1.6185497962,26080,2248,1219,4.0330100758,21053,2.1707598416,20172,4585,998,16.923913097,20155,1.0417361972,4980,4354
2021-2022,10,03,Capitale-Nationale,CHU DE QUÉBEC - UNIVERSITÉ LAVAL,HÔPITAL DU SAINT-SACREMENT,51217529,26407,5465,752,7.727218267,21598,1.9865369479,19304,2320,302,3.5890744434,14517,2.3681519942,7103,1972,599,18.973554797,7081,1.2041749047,3145,450
2021-2022,10,03,Capitale-Nationale,CHU DE QUÉBEC - UNIVERSITÉ LAVAL,HÔPITAL SAINT-FRANÇOIS D'ASSISE,51217602,31741,6650,1074,9.6195075857,25862,2.0160655058,19539,2010,499,4.1788915758,13688,2.7215452302,12202,3492,619,18.33153809,12174,1.2228499261,4640,575
2021-2022,10,03,Capitale-Nationale,CHU DE QUÉBEC - UNIVERSITÉ LAVAL,L'HÔTEL-DIEU DE QUÉBEC,51217586,14182,3585,728,8.6367436618,12984,1.6030537585,7138,972,298,3.5108536861,5993,1.8094844448,7044,1131,51,13.831037053,6991,1.4260920787,2613,430
2021-2022,10,03,Capitale-Nationale,CIUSSS DE LA CAPITALE-NATIONALE,CENTRE MULTISERVICES DE SANTÉ ET DE SERVICES SOCIAUX CHAUVEAU,51225001,21136,1398,298,3.3737269219,15475,1.9058232454,19301,1201,246,3.2270708196,13656,1.9996468789,1835,0,0,4.9162933697,1819,1.2014496671,197,52
2021-2022,10,03,Capitale-Nationale,CIUSSS DE LA CAPITALE-NATIONALE,CENTRE MULTISERVICES DE SANTÉ ET DE SERVICES SOCIAUX DE BAIE-SAINT-PAUL,51244804,8883,1492,272,3.9130767884,7293,1.5404066304,6925,833,113,2.4741911753,5341,1.7272604485,1958,64,0,9.0020874475,1952,1.0291431865,659,159
2021-2022,10,03,Capitale-Nationale,CIUSSS DE LA CAPITALE-NATIONALE,CENTRE MULTISERVICES DE SANTÉ ET DE SERVICES SOCIAUX DE SAINT-MARC-DES-CARRIÈRES,51247344,11996,1590,292,3.1654843513,9727,1.5855915093,9791,863,183,2.4622605794,7556,1.8366235442,2205,32,0,6.288053036,2171,0.7118936486,727,109
2021-2022,10,03,Capitale-Nationale,CIUSSS DE LA CAPITALE-NATIONALE,CENTRE MULTISERVICES DE SANTÉ ET DE SERVICES SOCIAUX DE SAINT-RAYMOND,51247302,15179,1800,292,3.8406215641,11961,2.1582125937,12153,951,175,3.0092927672,8980,2.4971253403,3026,69,4,7.1793984541,2981,1.1372677886,849,117
2021-2022,10,03,Capitale-Nationale,CIUSSS DE LA CAPITALE-NATIONALE,CENTRE MULTISERVICES DE SANTÉ ET DE SERVICES SOCIAUX DE SAINTE-ANNE-DE-BEAUPRÉ,51225357,13315,1394,220,3.4372367422,9943,1.8133145038,11794,917,167,2.8457646308,8435,1.9423120925,1521,52,4,8.0235760465,1508,1.0917663204,477,53
2021-2022,10,03,Capitale-Nationale,CIUSSS DE LA CAPITALE-NATIONALE,HÔPITAL ET CLSC DE LA MALBAIE,51228690,10843,1714,358,4.9096469048,9140,1.7604189764,8798,1011,206,3.1580402427,7099,2.0188262431,2045,229,21,12.445409943,2041,0.8616276063,703,152
2021-2022,10,03,Capitale-Nationale,INSTITUT UNIVERSITAIRE DE CARDIOLOGIE ET DE PNEUMOLOGIE DE QUÉBEC - UNIVERSITÉ LAVAL,INSTITUT UNIVERSITAIRE DE CARDIOLOGIE ET DE PNEUMOLOGIE DE QUÉBEC,51232130,20645,6245,477,7.5875789807,19589,1.7630391348,10698,2109,273,3.878100268,9657,2.2157601567,9947,810,0,11.577123896,9932,1.3228531794,4136,204
2021-2022,10,04,Mauricie et Centre-du-Québec,CIUSSS DE LA MAURICIE-ET-DU-CENTRE-DU-QUÉBEC,CENTRE MULTISERVICES DE SANTÉ ET DE SERVICES SOCIAUX AVELLIN-DALCOURT,51233583,15884,2199,416,5.4786324114,13242,3.3278400795,13304,1204,298,4.6869379301,10677,3.7696165433,2580,93,7,9.5610755814,2565,1.4889132554,995,118
2021-2022,10,04,Mauricie et Centre-du-Québec,CIUSSS DE LA MAURICIE-ET-DU-CENTRE-DU-QUÉBEC,CENTRE MULTISERVICES DE SANTÉ ET DE SERVICES SOCIAUX CHRIST-ROI,51246338,16256,1594,490,5.0987097926,12831,3.5149147248,13722,783,313,4.1332850532,10353,3.7372174732,2534,176,15,10.326633342,2478,2.5861413775,811,177
2021-2022,10,04,Mauricie et Centre-du-Québec,CIUSSS DE LA MAURICIE-ET-DU-CENTRE-DU-QUÉBEC,CENTRE MULTISERVICES DE SANTÉ ET DE SERVICES SOCIAUX DE FORTIERVILLE,51219160,10856,854,202,2.16225871,9110,1.5298594341,10024,743,178,2.0555024885,8281,1.5876626883,832,0,0,3.4484658787,829,0.9524544297,111,24
2021-2022,10,04,Mauricie et Centre-du-Québec,CIUSSS DE LA MAURICIE-ET-DU-CENTRE-DU-QUÉBEC,CENTRE MULTISERVICES DE SANTÉ ET DE SERVICES SOCIAUX DU HAUT-SAINT-MAURICE,51219731,8708,1309,475,4.9407806678,7592,2.5233220642,6443,662,245,3.7542018039,5372,2.7640129892,2265,57,1,8.3161129507,2220,1.9408933934,647,230
2021-2022,10,04,Mauricie et Centre-du-Québec,CIUSSS DE LA MAURICIE-ET-DU-CENTRE-DU-QUÉBEC,HÔPITAL DU CENTRE-DE-LA-MAURICIE,51220051,26821,4761,1812,6.3749788205,21069,2.5530176642,16192,1288,381,4.07839794,10534,3.5103941206,10629,560,17,9.8735429015,10535,1.5957320835,3473,1431
2021-2022,10,04,Mauricie et Centre-du-Québec,CIUSSS DE LA MAURICIE-ET-DU-CENTRE-DU-QUÉBEC,HÔPITAL SAINTE-CROIX,51228781,31816,4376,2059,7.4733100309,24632,3.0978914059,20240,1323,832,5.3123191151,13333,3.8350622307,11576,1081,7,11.25168392,11299,2.2280180891,3053,1227
2021-2022,10,04,Mauricie et Centre-du-Québec,CIUSSS DE LA MAURICIE-ET-DU-CENTRE-DU-QUÉBEC,HÔTEL-DIEU D'ARTHABASKA,51228039,26963,4475,1596,5.8794209246,21579,2.2791911246,15872,1358,375,3.5732522506,10707,2.8391725818,11091,661,11,9.1797102756,10872,1.7277082822,3117,1221
2021-2022,10,04,Mauricie et Centre-du-Québec,CIUSSS DE LA MAURICIE-ET-DU-CENTRE-DU-QUÉBEC,PAVILLON SAINTE-MARIE,51220168,46213,9587,2868,10.027190431,34510,3.4182947777,25835,2117,877,5.4549029095,14393,5.0562164671,20378,4743,288,15.823885304,20117,2.2464199019,7470,1991
2021-2022,10,05,Estrie,CIUSSS DE L'ESTRIE - CENTRE HOSPITALIER UNIVERSITAIRE DE SHERBROOKE,CENTRE DE SANTÉ ET DE SERVICES SOCIAUX DU GRANIT,51223832,10678,1623,374,6.5731561258,9068,3.5212481008,8489,894,246,5.0865646392,6890,3.8192650379,2189,254,26,12.3381973,2178,2.5784856137,729,128
2021-2022,10,05,Estrie,CIUSSS DE L'ESTRIE - CENTRE HOSPITALIER UNIVERSITAIRE DE SHERBROOKE,CENTRE MULTISERVICES DE SANTÉ ET DE SERVICES SOCIAUX DE LA MRC DE COATICOOK,51247617,11577,953,342,3.0569034148,9967,1.9798494755,8841,490,230,2.4881093768,7310,1.938005396,2736,33,4,4.894881518,2657,2.0949718772,463,112
2021-2022,10,05,Estrie,CIUSSS DE L'ESTRIE - CENTRE HOSPITALIER UNIVERSITAIRE DE SHERBROOKE,CENTRE MULTISERVICES DE SANTÉ ET DE SERVICES SOCIAUX DE MEMPHRÉMAGOG,51219046,16307,3217,573,6.4856100482,13730,2.7405428097,11290,1310,282,3.9853582325,8812,3.0853955465,5017,691,109,12.112048756,4918,2.1226407528,1907,291
2021-2022,10,05,Estrie,CIUSSS DE L'ESTRIE - CENTRE HOSPITALIER UNIVERSITAIRE DE SHERBROOKE,CENTRE MULTISERVICES DE SANTÉ ET DE SERVICES SOCIAUX DES SOURCES,51247583,12450,1323,382,5.0598075636,10001,3.4270629881,11033,855,308,4.4332809652,8595,3.6576018034,1417,80,16,9.9380488905,1406,2.0177592066,468,74
2021-2022,10,05,Estrie,CIUSSS DE L'ESTRIE - CENTRE HOSPITALIER UNIVERSITAIRE DE SHERBROOKE,CHUS - HÔPITAL FLEURIMONT,51216687,35434,4409,876,8.0734623996,30644,2.3778336162,19008,797,376,5.3224686097,14223,3.7504640371,16426,1751,77,11.256884411,16421,1.1889338855,3612,500
2021-2022,10,05,Estrie,CIUSSS DE L'ESTRIE - CENTRE HOSPITALIER UNIVERSITAIRE DE SHERBROOKE,CHUS - HÔTEL-DIEU DE SHERBROOKE,51216695,36318,6577,4425,9.7814545588,30557,2.5224787555,17380,1479,957,4.7870032605,11657,3.7876211718,18938,3354,747,14.365020065,18900,1.7421737213,5098,3468
2021-2022,10,05,Estrie,CIUSSS DE L'ESTRIE - CENTRE HOSPITALIER UNIVERSITAIRE DE SHERBROOKE,HÔPITAL BROME-MISSISQUOI-PERKINS,51229185,20848,3107,652,9.2164839286,17087,3.3323110324,14612,1044,338,5.2003730762,10916,3.8362230772,6236,1652,523,18.626909165,6171,2.4409313725,2063,314
2021-2022,10,05,Estrie,CIUSSS DE L'ESTRIE - CENTRE HOSPITALIER UNIVERSITAIRE DE SHERBROOKE,HÔPITAL DE GRANBY,51228120,29292,4470,1928,9.6833754097,23078,3.5892449519,20038,1557,753,5.7318098114,13879,4.5548096245,9254,2626,536,18.239834396,9199,2.1324483338,2913,1175
2021-2022,10,06,Montréal,CENTRE HOSPITALIER DE L'UNIVERSITÉ DE MONTRÉAL,CENTRE HOSPITALIER DE L'UNIVERSITÉ DE MONTRÉAL,51236297,48543,7027,3877,13.321388855,39149,2.9683620768,29587,2129,1476,6.9970276454,20344,4.2657018722,18956,7207,1899,23.192610373,18805,1.5648480753,4898,2401
2021-2022,10,06,Montréal,CENTRE HOSPITALIER UNIVERSITAIRE SAINTE-JUSTINE,CHU SAINTE-JUSTINE,51222800,63685,1,1747,5.2686936266,55583,1.9325915997,44252,1,888,4.5366185646,36734,2.2398278162,19433,256,0,6.9357437806,18849,1.3338322398,0,859
2021-2022,10,06,Montréal,CENTRE UNIVERSITAIRE DE SANTÉ MCGILL,HÔPITAL DE LACHINE,51228310,11886,1951,472,8.5555271608,10881,2.2422965873,8434,786,190,3.9374474679,7478,2.3005107575,3452,888,343,19.838517928,3403,2.1143725308,1165,282
2021-2022,10,06,Montréal,CENTRE UNIVERSITAIRE DE SANTÉ MCGILL,HÔPITAL GÉNÉRAL DE MONTRÉAL,51248219,24386,3883,2964,13.408946994,21190,1.8279745949,8788,599,501,5.4213675214,5732,2.6479788904,15598,3614,1216,17.909193718,15458,1.5239077932,3284,2463
2021-2022,10,06,Montréal,CENTRE UNIVERSITAIRE DE SANTÉ MCGILL,HÔPITAL ROYAL VICTORIA,51223295,36644,5582,879,14.420737736,29128,3.645969943,24049,1702,442,7.6554150092,16661,4.5292862573,12595,4899,2184,27.338502426,12467,2.4654988503,3880,437
2021-2022,10,06,Montréal,CENTRE UNIVERSITAIRE DE SANTÉ MCGILL,L'HÔPITAL DE MONTRÉAL POUR ENFANTS,51223279,55815,1,2061,6.1906268476,50025,2.1313519074,43094,0,662,5.404039361,37362,2.5191716628,12721,446,30,8.8552916656,12663,0.9870952776,1,1399
2021-2022,10,06,Montréal,CIUSSS DE L'EST-DE-L'ÎLE-DE-MONTRÉAL,HÔPITAL MAISONNEUVE-ROSEMONT,12934659,49646,8830,4183,12.508994531,36366,3.7185185338,28106,1927,1052,5.7544928821,15139,5.0705235007,21540,7331,2051,21.322458939,21227,2.7542747313,6903,3131
2021-2022,10,06,Montréal,CIUSSS DE L'EST-DE-L'ÎLE-DE-MONTRÉAL,HÔPITAL SANTA CABRINI,51235919,25512,6147,915,12.849216382,21577,2.9533789194,15210,1509,359,5.5536365878,11308,4.0976658609,10302,3691,1404,23.620500469,10269,1.6933149663,4638,556
2021-2022,10,06,Montréal,CIUSSS DE L'EST-DE-L'ÎLE-DE-MONTRÉAL,INSTITUT UNIVERSITAIRE EN SANTÉ MENTALE DE MONTRÉAL,51235307,3516,122,3508,15.758951934,3412,1.1915510616,1572,28,1566,3.4439434902,1469,1.3511279404,1944,853,283,25.717384688,1943,1.0709033854,94,1942
2021-2022,10,06,Montréal,CIUSSS DE L'OUEST-DE-L'ÎLE-DE-MONTRÉAL,CENTRE HOSPITALIER DE ST. MARY,51248243,25795,4789,1921,9.6312280696,24227,2.0865712956,17169,1559,614,5.1069643608,15608,2.4947053683,8626,2344,308,18.636222692,8619,1.3474882688,3230,1307
2021-2022,10,06,Montréal,CIUSSS DE L'OUEST-DE-L'ÎLE-DE-MONTRÉAL,HÔPITAL DE LASALLE,51224392,19573,2664,628,9.6832836617,15996,3.561098608,14469,956,246,6.0919704771,10934,4.2023507205,5104,1484,443,19.864065493,5062,2.1759839106,1708,382
2021-2022,10,06,Montréal,CIUSSS DE L'OUEST-DE-L'ÎLE-DE-MONTRÉAL,HÔPITAL DOUGLAS,51235190,4588,88,4388,7.4268378257,4136,2.1722141629,2574,42,2380,3.5726155789,2123,2.1341726854,2014,239,17,12.352740538,2013,2.2123344097,46,2008
2021-2022,10,06,Montréal,CIUSSS DE L'OUEST-DE-L'ÎLE-DE-MONTRÉAL,HÔPITAL GÉNÉRAL DU LAKESHORE,51228278,29459,5907,1826,14.39647792,24940,2.7872222222,18568,1720,273,7.2325608723,14088,3.6074839107,10891,4231,1963,26.610196748,10852,1.7223635172,4187,1553
2021-2022,10,06,Montréal,CIUSSS DU CENTRE-OUEST-DE-L'ÎLE-DE-MONTRÉAL,HÔPITAL GÉNÉRAL JUIF,51248250,65449,11378,3362,9.1144176764,59428,1.8809048531,27286,1615,467,4.0046146783,21941,2.1081554193,38163,5172,957,12.767853848,37487,1.7478959521,9763,2895
2021-2022,10,06,Montréal,CIUSSS DU CENTRE-SUD-DE-L'ÎLE-DE-MONTRÉAL,HÔPITAL DE VERDUN,51218097,28921,4589,2277,9.4448981229,26012,1.7697419567,18947,1428,831,3.8461122547,16081,2.1892503403,9974,3470,569,20.080570455,9931,1.0904433648,3161,1446
2021-2022,10,06,Montréal,CIUSSS DU CENTRE-SUD-DE-L'ÎLE-DE-MONTRÉAL,HÔPITAL NOTRE-DAME,51236313,27295,3575,3804,13.127037258,23051,2.5657317229,17766,963,1756,5.9279461706,13556,3.3705624406,9529,3794,1419,26.549122707,9495,1.416675882,2612,2048
2021-2022,10,06,Montréal,CIUSSS DU NORD-DE-L'ÎLE-DE-MONTRÉAL,HÔPITAL DU SACRÉ-COEUR-DE-MONTRÉAL,12475976,45437,8387,2152,11.647847135,38416,2.4760648269,29142,2366,965,5.6617951468,22157,3.4102544969,16295,6046,1918,22.353310593,16259,1.2029951104,6021,1187
2021-2022,10,06,Montréal,CIUSSS DU NORD-DE-L'ÎLE-DE-MONTRÉAL,HÔPITAL EN SANTÉ MENTALE ALBERT-PRÉVOST,51848752,2561,94,2547,19.929801618,2521,0.2677289656,1160,31,1146,3.8983560824,1120,0.4126904762,1401,823,298,33.203518122,1401,0.1518425331,63,1401
2021-2022,10,06,Montréal,CIUSSS DU NORD-DE-L'ÎLE-DE-MONTRÉAL,HÔPITAL FLEURY,51228492,23016,3654,970,9.0575646652,17366,3.4185642123,17210,1422,497,5.6454581477,11580,4.1707743235,5806,1783,153,19.171645472,5786,1.9131039482,2232,473
2021-2022,10,06,Montréal,CIUSSS DU NORD-DE-L'ÎLE-DE-MONTRÉAL,HÔPITAL JEAN-TALON,51228500,29649,3797,2359,8.0107958953,23398,3.1362149899,21940,1187,1037,5.420322597,15709,4.0175208302,7709,1566,90,15.383345404,7689,1.3356644051,2610,1322
2021-2022,10,06,Montréal,INSTITUT DE CARDIOLOGIE DE MONTRÉAL,INSTITUT DE CARDIOLOGIE DE MONTRÉAL,51248201,13767,3664,420,9.4433252625,13377,1.4588999568,8433,1462,357,3.5499502945,8046,1.6729105214,5334,1637,167,18.760691424,5331,1.1358969549,2202,63
2021-2022,10,07,Outaouais,CISSS DE L'OUTAOUAIS,CENTRE MULTISERVICES DE SANTÉ ET DE SERVICES SOCIAUX DE MANSFIELD-ET-PONTEFRACT,51245058,6729,701,220,4.0385796139,6445,1.331758426,6512,660,207,3.8923869608,6228,1.3249301541,217,6,0,8.4257066052,217,1.5277329749,41,13
2021-2022,10,07,Outaouais,CISSS DE L'OUTAOUAIS,CLSC ET CENTRE D'HÉBERGEMENT DE LA PETITE-NATION,51219491,7943,894,342,2.9688930155,6933,1.3809656314,7233,682,313,2.7855936525,6224,1.4502061465,710,3,0,4.8362230047,709,0.7731335214,212,29
2021-2022,10,07,Outaouais,CISSS DE L'OUTAOUAIS,HÔPITAL DE GATINEAU,51221703,22758,2606,3206,10.154573679,15132,2.4406080198,14802,1019,845,3.549145123,7285,2.6026697552,7956,2412,1142,22.443858932,7847,2.2901531017,1587,2361
2021-2022,10,07,Outaouais,CISSS DE L'OUTAOUAIS,HÔPITAL DE HULL,51221711,26489,4675,1208,11.336894361,19302,2.6664522819,16330,1362,717,4.8830888447,9283,3.0151915688,10159,2872,1252,21.711010325,10019,2.3433315312,3313,491
2021-2022,10,07,Outaouais,CISSS DE L'OUTAOUAIS,HÔPITAL DE MANIWAKI,51221893,9451,1279,547,7.3676705875,8358,2.2883547034,6566,626,316,3.6256948252,5572,2.3487123614,2885,510,287,15.884070191,2786,2.1676393874,653,231
2021-2022,10,07,Outaouais,CISSS DE L'OUTAOUAIS,HÔPITAL ET CHSLD DE PAPINEAU,51228823,15718,1883,796,7.8950508087,11311,2.9875146858,11339,728,291,3.4020922627,6998,3.0851295608,4379,1207,335,19.529135521,4313,2.8291309864,1155,505
2021-2022,10,07,Outaouais,CISSS DE L'OUTAOUAIS,HÔPITAL ET CHSLD DU PONTIAC,51219459,7066,876,189,4.8209845662,6433,1.9590284902,6276,690,151,4.2414797553,5645,2.0202074107,790,51,1,9.4247468354,788,1.5207607163,186,38
2021-2022,10,07,Outaouais,CISSS DE L'OUTAOUAIS,HÔPITAL ET CHSLD MÉMORIAL DE WAKEFIELD / WAKEFIELD MEMORIAL HOSPITAL,51228799,10102,811,291,5.1081932896,8594,2.3166071936,8884,560,221,3.8990140827,7402,2.3707326473,1218,210,33,13.92785509,1192,1.9805026566,251,70
2021-2022,10,08,Abitibi-Témiscamingue,CISSS DE L'ABITIBI-TÉMISCAMINGUE,CENTRE MULTISERVICES DE SANTÉ ET DE SERVICES SOCIAUX DE LA SARRE,51247559,13713,1527,723,4.9612354052,12219,1.9722925135,11805,966,617,4.1535159066,10330,2.0711990158,1908,134,32,9.9586823026,1889,1.4314221222,561,106
2021-2022,10,08,Abitibi-Témiscamingue,CISSS DE L'ABITIBI-TÉMISCAMINGUE,CENTRE MULTISERVICES DE SANTÉ ET DE SERVICES SOCIAUX DE TÉMISCAMING-KIPAWA,51247476,3707,355,226,2.3346402452,3535,0.6555567342,3666,338,219,2.2284317603,3494,0.6573214399,41,0,0,11.831233062,41,0.5051693767,17,7
2021-2022,10,08,Abitibi-Témiscamingue,CISSS DE L'ABITIBI-TÉMISCAMINGUE,CENTRE MULTISERVICES DE SANTÉ ET DE SERVICES SOCIAUX DE VILLE-MARIE,51247542,9113,1174,512,5.2038100028,7833,2.9872439253,8177,858,426,4.5396348838,6908,3.058543637,936,53,1,11.00611764,925,2.45476997,316,86
2021-2022,10,08,Abitibi-Témiscamingue,CISSS DE L'ABITIBI-TÉMISCAMINGUE,HÔPITAL D'AMOS,51228906,15969,1556,653,4.4386920492,13690,1.2643233301,12099,658,502,2.3932861072,9846,1.4345515946,3870,437,69,10.833360393,3844,0.82830161,898,151
2021-2022,10,08,Abitibi-Témiscamingue,CISSS DE L'ABITIBI-TÉMISCAMINGUE,HÔPITAL DE ROUYN-NORANDA,51228922,20321,2322,1268,6.246022109,15100,3.4158820456,16297,1111,796,5.2003861311,11126,3.9109793127,4024,313,18,10.48079585,3974,2.0297591987,1211,472
2021-2022,10,08,Abitibi-Témiscamingue,CISSS DE L'ABITIBI-TÉMISCAMINGUE,HÔPITAL DE VAL-D'OR,51225589,20709,2114,1547,7.7215406211,15876,4.1717398204,16660,1115,1119,5.7459545985,11837,4.9107969127,4049,921,150,15.850279356,4039,2.005803004,999,428
2021-2022,10,09,Côte-Nord,CISSS DE LA CÔTE-NORD,CENTRE MULTISERVICES DE SANTÉ ET DE SERVICES SOCIAUX DE FERMONT,51245108,4298,13,205,8.345138695,3620,1.4236617557,4131,12,194,8.4033092606,3453,1.4429464717,167,7,3,6.9062009315,167,1.0249184963,1,11
2021-2022,10,09,Côte-Nord,CISSS DE LA CÔTE-NORD,CENTRE MULTISERVICES DE SANTÉ ET DE SERVICES SOCIAUX DE FORESTVILLE,51218741,8128,1141,348,3.4285224259,6563,1.8893417644,7046,808,271,2.9089662377,5604,2.0024263423,1082,33,4,6.8118800062,959,1.2285221875,333,77
2021-2022,10,09,Côte-Nord,CISSS DE LA CÔTE-NORD,CENTRE MULTISERVICES DE SANTÉ ET DE SERVICES SOCIAUX DE LA BASSE-CÔTE-NORD,51245140,2783,357,140,3.3097099453,2692,1.1949342703,2299,255,128,3.1405242618,2217,1.2311445647,484,0,0,4.1133419421,475,1.0259274854,102,12
2021-2022,10,09,Côte-Nord,CISSS DE LA CÔTE-NORD,CENTRE MULTISERVICES DE SANTÉ ET DE SERVICES SOCIAUX DE LA MINGANIE,51245116,10666,785,316,2.5288504229,5403,2.0112217492,7939,524,144,1.6328091279,2803,2.169448904,2727,37,1,5.1374576254,2600,1.8406407051,261,172
2021-2022,10,09,Côte-Nord,CISSS DE LA CÔTE-NORD,CENTRE MULTISERVICES DE SANTÉ ET DE SERVICES SOCIAUX DE PORT-CARTIER,51245132,10003,707,517,4.0439508703,8949,1.88213919,9094,493,429,2.97122703,8049,1.9810913019,909,140,38,14.77590973,900,0.9971774691,214,88
2021-2022,10,09,Côte-Nord,CISSS DE LA CÔTE-NORD,CENTRE MULTISERVICES DE SANTÉ ET DE SERVICES SOCIAUX DES ESCOUMINS,51218733,6679,927,228,3.336045233,5956,1.2602837941,5913,644,195,2.7224855309,5195,1.30782681,766,31,8,8.0723096171,761,0.9357293035,283,33
2021-2022,10,09,Côte-Nord,CISSS DE LA CÔTE-NORD,CLSC ET HÔPITAL LE ROYER,51228765,15907,2375,1250,10.87024383,13959,3.5672381419,11603,986,786,5.6709870532,9665,4.1021827614,4304,1379,720,24.886734627,4294,2.3631767195,1389,464
2021-2022,10,09,Côte-Nord,CISSS DE LA CÔTE-NORD,HÔPITAL ET CLSC DE SEPT-ÎLES,51232023,15914,1927,1184,10.63171191,12590,3.1464227562,10385,726,456,4.2822741401,7203,3.3571924892,5529,1408,709,22.557722262,5387,2.864600891,1201,728
2021-2022,10,11,Gaspésie-Îles-de-la-Madeleine,CISSS DE LA GASPÉSIE,CENTRE MULTISERVICES DE SANTÉ ET DE SERVICES SOCIAUX DE GRANDE-VALLÉE,51247732,4422,699,88,1.6278532841,3270,0.7859259259,4007,550,72,1.2939932895,2934,0.8043469287,415,9,2,4.8514123159,336,0.6250710979,149,16
2021-2022,10,11,Gaspésie-Îles-de-la-Madeleine,CISSS DE LA GASPÉSIE,CLSC ET CENTRE DE SERVICES AMBULATOIRES DE MURDOCHVILLE,51221307,1249,187,70,3.2650509296,1198,1.5791655073,1231,181,69,3.1946473057,1180,1.5845722693,18,0,0,8.0798765432,18,1.2247222222,6,1
2021-2022,10,11,Gaspésie-Îles-de-la-Madeleine,CISSS DE LA GASPÉSIE,CLSC ET CENTRE DE SERVICES AMBULATOIRES DE PASPÉBIAC,51220978,9163,1614,371,3.835008367,8363,1.8035326571,6864,1005,289,3.010525123,6179,1.9006647066,2299,67,8,6.2966234111,2184,1.5287254528,609,82
2021-2022,10,11,Gaspésie-Îles-de-la-Madeleine,CISSS DE LA GASPÉSIE,HÔPITAL DE CHANDLER,51227775,10943,1826,463,5.2866927615,9727,1.8389049096,9067,1128,370,3.5951249341,7860,1.9932829375,1876,255,20,13.462303364,1867,1.1889792001,698,93
2021-2022,10,11,Gaspésie-Îles-de-la-Madeleine,CISSS DE LA GASPÉSIE,HÔPITAL DE GASPÉ,51220903,10928,1645,484,4.9726568092,9610,1.563923257,8700,905,344,3.4995612069,7397,1.7809790005,2228,174,1,10.724870337,2213,0.8384097756,740,140
2021-2022,10,11,Gaspésie-Îles-de-la-Madeleine,CISSS DE LA GASPÉSIE,HÔPITAL ET CLSC DE SAINTE-ANNE-DES-MONTS,51247799,10305,1560,449,4.3595659604,9199,1.5471191917,8324,855,332,2.4516829516,7234,1.5962297254,1981,260,82,12.376334343,1965,1.3663224484,705,117
2021-2022,10,11,Gaspésie-Îles-de-la-Madeleine,CISSS DE LA GASPÉSIE,HÔPITAL ET GROUPE DE MÉDECINE DE FAMILLE UNIVERSITAIRE DE MARIA,51227908,12372,2086,601,8.5112201387,11190,2.2559160212,8983,957,276,4.2532740856,7814,2.5322753676,3389,1062,346,19.797478443,3376,1.6162620129,1129,325
2021-2022,10,11,Gaspésie-Îles-de-la-Madeleine,CISSS DES ÎLES,HÔPITAL DE L'ARCHIPEL,51227783,12461,1529,374,3.4262521289,10899,1.1381401199,10431,1036,212,2.3222399046,8878,1.2119776414,2030,110,2,9.099134647,2021,0.8137811315,493,162
2021-2022,10,12,Chaudière-Appalaches,CISSS DE CHAUDIÈRE-APPALACHES,CHSLD ET HÔPITAL PAUL-GILBERT,51245199,12209,750,187,2.2991226418,10391,1.3485360194,11398,663,169,2.2184456094,9582,1.4076513544,811,0,0,3.4329781477,809,0.6483590853,87,18
2021-2022,10,12,Chaudière-Appalaches,CISSS DE CHAUDIÈRE-APPALACHES,HÔPITAL DE MONTMAGNY,51245223,24730,3600,837,4.2672269286,22718,1.3932752296,18786,1677,398,2.4645530359,16780,1.6263008376,5944,294,2,9.964574127,5938,0.734775785,1923,439
2021-2022,10,12,Chaudière-Appalaches,CISSS DE CHAUDIÈRE-APPALACHES,HÔPITAL DE SAINT-GEORGES,51228971,30650,5129,1639,6.4379144009,25510,2.0399868243,20911,1771,721,3.5563383041,15799,2.4994794853,9739,1136,35,12.625062749,9711,1.2924299763,3358,918
2021-2022,10,12,Chaudière-Appalaches,CISSS DE CHAUDIÈRE-APPALACHES,HÔPITAL DE THETFORD,51245231,27547,4290,857,5.7894036253,24399,1.3714603854,21127,2058,423,3.7602853116,17980,1.5609583333,6420,777,22,12.4668464,6419,0.8406653857,2232,434
2021-2022,10,12,Chaudière-Appalaches,CISSS DE CHAUDIÈRE-APPALACHES,HÔTEL-DIEU DE LÉVIS,51227569,60901,10334,3774,6.71325594,52212,1.0211890253,42439,3687,1834,2.6567741805,33752,1.2766863939,18462,4269,584,16.037978581,18460,0.5540412905,6647,1940
2021-2022,10,13,Laval,CISSS DE LAVAL,HÔPITAL DE LA CITÉ-DE-LA-SANTÉ,51228757,68609,11118,4352,8.4179448032,52927,2.819525363,45341,3309,1285,4.8783485942,29726,3.5863187763,23268,4106,291,15.315350326,23201,1.8370805976,7809,3067
2021-2022,10,14,Lanaudière,CISSS DE LANAUDIÈRE,HÔPITAL DE LANAUDIÈRE ET CENTRE D'HÉBERGEMENT PARPHILIA-FERLAND,51244945,50705,8242,3609,9.2537517558,42461,2.342876993,32112,2255,2518,5.2529734558,23987,3.0094813394,18593,4539,660,16.163502349,18474,1.4773449773,5987,1091
2021-2022,10,14,Lanaudière,CISSS DE LANAUDIÈRE,HÔPITAL PIERRE-LE GARDEUR,51228062,57174,8988,3260,10.583712551,38600,4.5247973086,38794,3020,1167,6.3891691656,20300,5.8992197455,18380,6179,642,19.436983285,18300,3.0001647693,5968,2093
2021-2022,10,15,Laurentides,CISSS DES LAURENTIDES,CENTRE MULTISERVICES DE SANTÉ ET DE SERVICES SOCIAUX D'ARGENTEUIL,51245306,15583,1842,629,8.179651686,13182,3.132760709,12818,999,420,5.0985397488,10426,3.4709588475,2765,926,301,22.46308489,2756,1.85335077,843,209
2021-2022,10,15,Laurentides,CISSS DES LAURENTIDES,CENTRE MULTISERVICES DE SANTÉ ET DE SERVICES SOCIAUX DE RIVIÈRE-ROUGE,51217628,10776,1232,622,6.3160656397,9581,2.3506783971,8298,637,307,3.3337658673,7144,2.483114385,2478,529,166,16.302798292,2437,1.9624458578,595,315
2021-2022,10,15,Laurentides,CISSS DES LAURENTIDES,CENTRE MULTISERVICES DE SANTÉ ET DE SERVICES SOCIAUX DE SAINTE-AGATHE,51246874,22579,3552,1456,12.48711396,17784,3.997762127,14957,1341,446,6.8979937487,10238,5.0340758829,7622,2691,910,23.454900762,7546,2.591748314,2211,1010
2021-2022,10,15,Laurentides,CISSS DES LAURENTIDES,HÔPITAL DE MONT-LAURIER,51217610,13018,1737,743,8.7747120653,10582,3.3200859688,9955,862,432,6.0405954015,7574,3.6272761714,3063,753,183,17.66081438,3008,2.5465957447,875,311
2021-2022,10,15,Laurentides,CISSS DES LAURENTIDES,HÔPITAL DE SAINT-EUSTACHE,51228864,36302,6637,2111,12.057371762,25915,3.2428035565,21438,1732,715,6.0123431523,11119,4.9554575002,14864,4993,1396,20.775975324,14796,1.9557665735,4905,1396
2021-2022,10,15,Laurentides,CISSS DES LAURENTIDES,HÔPITAL DE SAINT-JÉRÔME,51228880,41308,6817,3935,16.220920914,29620,4.5575678408,24576,2101,1199,7.5086081611,12988,6.3225698936,16732,7236,3373,29.01758588,16632,3.179270182,4716,2736
2021-2022,10,16,Montérégie,CISSS DE LA MONTÉRÉGIE-CENTRE,HÔPITAL CHARLES-LE MOYNE,51233799,58013,9506,4842,9.8088789055,32986,4.7352260134,40751,3558,2144,5.5893232613,15734,5.8047442375,17262,5643,659,19.770129749,17252,3.7598144821,5948,2698
2021-2022,10,16,Montérégie,CISSS DE LA MONTÉRÉGIE-CENTRE,HÔPITAL DU HAUT-RICHELIEU,51229045,47566,6925,2980,9.2413842229,36059,2.710934202,34170,2546,1195,4.8751153546,22726,3.3328626292,13396,4031,1564,20.378694407,13333,1.6508617924,4379,1785
2021-2022,10,16,Montérégie,CISSS DE LA MONTÉRÉGIE-EST,HÔPITAL HONORÉ-MERCIER,51229193,37011,6398,2206,9.1452279953,27440,3.2254310415,27536,2658,1150,4.7298205581,17983,3.8777841882,9475,3144,1067,21.977170918,9457,1.9849460423,3740,1056
2021-2022,10,16,Montérégie,CISSS DE LA MONTÉRÉGIE-EST,HÔPITAL PIERRE-BOUCHER,51229011,42710,7768,2523,12.520414163,31476,3.6814472402,20957,2019,728,4.9538504106,9937,4.8786271566,21753,6156,2674,19.810097266,21539,3.1291292668,5749,1795
2021-2022,10,16,Montérégie,CISSS DE LA MONTÉRÉGIE-EST,HÔTEL-DIEU DE SOREL,51229102,24877,4041,1315,9.1343070686,20597,2.6225688881,16358,1581,420,5.0769766917,12155,3.2725900407,8519,2146,517,16.92510532,8442,1.6866523862,2460,895
2021-2022,10,16,Montérégie,CISSS DE LA MONTÉRÉGIE-OUEST,HÔPITAL ANNA-LABERGE,51229151,30226,5273,1729,14.279445961,23617,2.3616205135,19108,1418,498,7.3649038797,12499,3.3067752087,11118,4642,1708,26.163154369,11118,1.2990653295,3855,1231
2021-2022,10,16,Montérégie,CISSS DE LA MONTÉRÉGIE-OUEST,HÔPITAL BARRIE MEMORIAL / BARRIE MEMORIAL HOSPITAL,51228005,14717,1490,274,6.3227600545,12102,3.6000502672,12363,827,215,4.4607568956,9763,3.1502570647,2354,558,53,16.101836118,2339,5.4774897867,663,59
2021-2022,10,16,Montérégie,CISSS DE LA MONTÉRÉGIE-OUEST,HÔPITAL DU SUROÎT,51229136,27238,5539,2215,15.438436702,22340,2.2023736944,17001,1520,1442,4.6667730493,12182,2.9890561667,10237,3689,2269,33.327374258,10158,1.2589433069,4019,773
2022-2023,10,01,Bas-Saint-Laurent,CISSS DU BAS-SAINT-LAURENT,CENTRE HOSPITALIER RÉGIONAL DU GRAND-PORTAGE,51218352,16793,2872,781,5.1725087503,13907,2.2832766273,12339,1168,460,3.3675548397,9497,2.5361078352,4454,134,5,10.172806528,4410,1.7388008944,1704,321
2022-2023,10,01,Bas-Saint-Laurent,CISSS DU BAS-SAINT-LAURENT,CENTRE MULTISERVICES DE SANTÉ ET DE SERVICES SOCIAUX DE TROIS-PISTOLES,51236156,8766,1190,228,3.3141064593,7899,1.436053544,7628,798,178,2.5338631431,6778,1.524415429,1138,58,1,8.544067809,1121,0.9017833779,392,50
2022-2023,10,01,Bas-Saint-Laurent,CISSS DU BAS-SAINT-LAURENT,CLSC DE POHÉNÉGAMOOK,51219418,8057,895,172,1.6745143974,7370,0.7979594829,7564,739,153,1.3537530113,6885,0.8057484467,493,10,0,6.5958919315,485,0.6873883162,156,19
2022-2023,10,01,Bas-Saint-Laurent,CISSS DU BAS-SAINT-LAURENT,HÔPITAL D'AMQUI,51226892,12633,1854,346,4.0239312603,11104,1.7290358079,7018,616,204,3.1486619328,5699,1.9537396912,5615,34,2,5.1179010092,5405,1.4921093638,1238,142
2022-2023,10,01,Bas-Saint-Laurent,CISSS DU BAS-SAINT-LAURENT,HÔPITAL DE MATANE,51218980,14737,2385,572,4.7477005723,13034,2.6993551907,11076,1135,306,4.2026880442,9467,3.054895661,3661,55,1,6.3965830526,3567,1.7557326418,1250,266
2022-2023,10,01,Bas-Saint-Laurent,CISSS DU BAS-SAINT-LAURENT,HÔPITAL DE NOTRE-DAME-DU-LAC,51221877,10769,1697,268,3.8793334004,9632,1.4935713709,8652,899,134,2.4267155635,7525,1.6529594315,2117,127,8,9.8160596756,2107,0.9243282972,798,134
2022-2023,10,01,Bas-Saint-Laurent,CISSS DU BAS-SAINT-LAURENT,HÔPITAL NOTRE-DAME-DE-FATIMA,51221141,13318,1996,340,3.405948716,12357,1.4220791184,10831,1029,183,2.5424104422,9889,1.5336928799,2487,11,1,7.1666978287,2468,0.9748552584,967,157
2022-2023,10,01,Bas-Saint-Laurent,CISSS DU BAS-SAINT-LAURENT,HÔPITAL RÉGIONAL DE RIMOUSKI,51227882,25577,4293,1224,5.744803491,19550,2.6219288292,18448,1690,746,4.2050288348,12475,3.0800980628,7129,361,12,9.7293402924,7075,1.8140615234,2603,478
2022-2023,10,02,Saguenay-Lac-Saint-Jean,CIUSSS DU SAGUENAY - LAC-SAINT-JEAN,HÔPITAL D'ALMA,51219400,27371,3770,970,5.2177806701,21276,3.0125200017,21121,1855,434,3.9151811783,15151,3.2207315982,6250,257,15,9.6197332889,6125,2.4974809977,1915,536
2022-2023,10,02,Saguenay-Lac-Saint-Jean,CIUSSS DU SAGUENAY - LAC-SAINT-JEAN,HÔPITAL DE CHICOUTIMI,51218394,42586,6317,2600,7.6873844169,36422,2.5641655074,25112,1793,832,3.950723647,19107,3.3893967743,17474,2603,427,13.057364116,17315,1.6535276895,4524,1768
2022-2023,10,02,Saguenay-Lac-Saint-Jean,CIUSSS DU SAGUENAY - LAC-SAINT-JEAN,HÔPITAL DE DOLBEAU-MISTASSINI,51219384,16663,2540,551,4.5218587423,14986,1.8834821389,14023,1583,300,3.0495657531,12368,2.0228967452,2640,365,90,12.342299874,2618,1.2248572914,957,251
2022-2023,10,02,Saguenay-Lac-Saint-Jean,CIUSSS DU SAGUENAY - LAC-SAINT-JEAN,HÔPITAL DE LA BAIE,51221364,15638,1744,457,5.1786596574,14239,2.6551603967,12614,813,278,3.9535988892,11247,2.8920356046,3024,171,26,10.288751102,2992,1.7647407903,931,179
2022-2023,10,02,Saguenay-Lac-Saint-Jean,CIUSSS DU SAGUENAY - LAC-SAINT-JEAN,HÔPITAL ET CENTRE D'HÉBERGEMENT DE ROBERVAL,51228203,19103,2496,1163,5.4540592664,17109,2.2029442269,13456,1016,382,3.2753228424,11546,2.3958928296,5647,569,98,10.645679122,5563,1.8024796273,1480,781
2022-2023,10,02,Saguenay-Lac-Saint-Jean,CIUSSS DU SAGUENAY - LAC-SAINT-JEAN,HÔPITAL ET CENTRE DE RÉADAPTATION DE JONQUIÈRE,51224541,20134,3376,975,8.1716624863,15798,4.1412994964,12552,1079,326,5.0850141633,8484,4.5121748127,7582,975,88,13.281608378,7314,3.7110962993,2297,649
2022-2023,10,03,Capitale-Nationale,CHU DE QUÉBEC - UNIVERSITÉ LAVAL,CENTRE HOSPITALIER DE L'UNIVERSITÉ LAVAL,51217594,59561,4196,5411,8.1289524139,48147,2.0113735885,34087,862,1784,4.7928398493,22752,3.0065181083,25474,2904,924,12.593036146,25395,1.1197993371,3334,3627
2022-2023,10,03,Capitale-Nationale,CHU DE QUÉBEC - UNIVERSITÉ LAVAL,HÔPITAL DE L'ENFANT-JÉSUS,51233914,45476,7314,5428,10.828671381,40659,1.7129800085,25751,2303,1423,4.1470616567,21002,2.1516785438,19725,5425,1527,19.55151711,19657,1.2442642005,5011,4005
2022-2023,10,03,Capitale-Nationale,CHU DE QUÉBEC - UNIVERSITÉ LAVAL,HÔPITAL DU SAINT-SACREMENT,51217529,26637,5870,702,8.1258024552,21362,2.0999494169,19070,2360,249,3.7600455194,13825,2.4982954591,7567,2079,629,19.128179192,7537,1.3692695664,3510,453
2022-2023,10,03,Capitale-Nationale,CHU DE QUÉBEC - UNIVERSITÉ LAVAL,HÔPITAL SAINT-FRANÇOIS D'ASSISE,51217602,31732,7353,994,10.647329151,25732,2.0828946232,19437,2147,471,4.2704176742,13472,2.7812409277,12295,4032,1056,20.728502666,12260,1.3155111474,5206,523
2022-2023,10,03,Capitale-Nationale,CHU DE QUÉBEC - UNIVERSITÉ LAVAL,L'HÔTEL-DIEU DE QUÉBEC,51217586,15278,3921,810,8.3461890554,13760,1.6221180556,7613,999,286,3.4368362961,6163,1.862427885,7665,1096,40,13.222236356,7597,1.427168802,2922,524
2022-2023,10,03,Capitale-Nationale,CIUSSS DE LA CAPITALE-NATIONALE,CENTRE MULTISERVICES DE SANTÉ ET DE SERVICES SOCIAUX CHAUVEAU,51225001,34368,2194,418,3.3648035964,22739,2.1472242989,31196,1847,335,3.2007914921,19632,2.276500017,3172,0,0,4.9778305836,3107,1.3303781783,347,83
2022-2023,10,03,Capitale-Nationale,CIUSSS DE LA CAPITALE-NATIONALE,CENTRE MULTISERVICES DE SANTÉ ET DE SERVICES SOCIAUX DE BAIE-SAINT-PAUL,51244804,10752,1812,293,4.5322309286,8235,2.0712528166,8635,1111,124,2.9909311266,6133,2.3402690817,2117,185,22,10.819015903,2102,1.286344751,701,169
2022-2023,10,03,Capitale-Nationale,CIUSSS DE LA CAPITALE-NATIONALE,CENTRE MULTISERVICES DE SANTÉ ET DE SERVICES SOCIAUX DE SAINT-MARC-DES-CARRIÈRES,51247344,13502,1737,294,3.263458644,10921,1.7313632756,10805,875,188,2.5305557612,8285,2.0089996982,2697,44,7,6.1996898818,2636,0.8587465225,862,106
2022-2023,10,03,Capitale-Nationale,CIUSSS DE LA CAPITALE-NATIONALE,CENTRE MULTISERVICES DE SANTÉ ET DE SERVICES SOCIAUX DE SAINT-RAYMOND,51247302,16494,1975,280,4.2938701784,12935,2.3030328351,13354,1033,162,3.3254293761,9830,2.6564236747,3140,119,11,8.4125193737,3105,1.1842463768,942,118
2022-2023,10,03,Capitale-Nationale,CIUSSS DE LA CAPITALE-NATIONALE,CENTRE MULTISERVICES DE SANTÉ ET DE SERVICES SOCIAUX DE SAINTE-ANNE-DE-BEAUPRÉ,51225357,14713,1571,220,3.9484749881,10739,2.1879212321,12822,964,163,3.2425864833,8906,2.3772654203,1891,86,11,8.7347798049,1833,1.267954325,607,57
2022-2023,10,03,Capitale-Nationale,CIUSSS DE LA CAPITALE-NATIONALE,HÔPITAL ET CLSC DE LA MALBAIE,51228690,11434,1821,335,5.7455122636,9367,1.940482812,9085,1035,192,3.4720803522,7035,2.2485366422,2349,394,89,14.53824488,2332,1.0111694778,786,143
2022-2023,10,03,Capitale-Nationale,INSTITUT UNIVERSITAIRE DE CARDIOLOGIE ET DE PNEUMOLOGIE DE QUÉBEC - UNIVERSITÉ LAVAL,INSTITUT UNIVERSITAIRE DE CARDIOLOGIE ET DE PNEUMOLOGIE DE QUÉBEC,51232130,21296,6746,475,8.2392077412,20110,1.969325239,10892,2210,245,4.0281928378,9733,2.4903320034,10404,1148,1,12.647740452,10377,1.480652324,4536,230
2022-2023,10,04,Mauricie et Centre-du-Québec,CIUSSS DE LA MAURICIE-ET-DU-CENTRE-DU-QUÉBEC,CENTRE MULTISERVICES DE SANTÉ ET DE SERVICES SOCIAUX AVELLIN-DALCOURT,51233583,17331,2230,379,5.7878358625,13459,3.8831941245,14772,1242,254,4.9824758552,10915,4.3434212602,2559,131,22,10.436830793,2544,1.9085953878,988,125
2022-2023,10,04,Mauricie et Centre-du-Québec,CIUSSS DE LA MAURICIE-ET-DU-CENTRE-DU-QUÉBEC,CENTRE MULTISERVICES DE SANTÉ ET DE SERVICES SOCIAUX CHRIST-ROI,51246338,18511,1818,460,5.9093409924,13633,4.2827502914,15901,940,315,4.936551597,11063,4.5719017094,2610,252,47,11.83590198,2570,3.0380490705,878,145
2022-2023,10,04,Mauricie et Centre-du-Québec,CIUSSS DE LA MAURICIE-ET-DU-CENTRE-DU-QUÉBEC,CENTRE MULTISERVICES DE SANTÉ ET DE SERVICES SOCIAUX DE FORTIERVILLE,51219160,11692,937,200,2.3005943047,8862,1.9210214022,10842,804,166,2.1948752536,8022,2.0021825397,850,0,0,3.6490718954,840,1.1459325397,133,34
2022-2023,10,04,Mauricie et Centre-du-Québec,CIUSSS DE LA MAURICIE-ET-DU-CENTRE-DU-QUÉBEC,CENTRE MULTISERVICES DE SANTÉ ET DE SERVICES SOCIAUX DU HAUT-SAINT-MAURICE,51219731,9746,1423,508,5.9487184201,8210,2.9816101638,7354,766,261,4.0918619497,5875,3.2386371158,2392,240,21,11.657465278,2335,2.3349149417,657,247
2022-2023,10,04,Mauricie et Centre-du-Québec,CIUSSS DE LA MAURICIE-ET-DU-CENTRE-DU-QUÉBEC,HÔPITAL DU CENTRE-DE-LA-MAURICIE,51220051,26489,4919,1739,8.0672962257,20700,2.8660896404,16376,1284,342,4.7390628392,10663,4.0057033928,10113,1481,192,13.456710834,10037,1.6553990513,3635,1397
2022-2023,10,04,Mauricie et Centre-du-Québec,CIUSSS DE LA MAURICIE-ET-DU-CENTRE-DU-QUÉBEC,HÔPITAL SAINTE-CROIX,51228781,32654,4338,1880,8.9008376122,23790,3.8202630657,20072,1261,515,6.3454153243,11592,5.0888328157,12582,1913,92,12.977489668,12198,2.6147162103,3077,1365
2022-2023,10,04,Mauricie et Centre-du-Québec,CIUSSS DE LA MAURICIE-ET-DU-CENTRE-DU-QUÉBEC,HÔTEL-DIEU D'ARTHABASKA,51228039,28589,4743,1629,6.4952297115,22990,2.195319825,17201,1439,342,3.705620878,11785,2.8049682977,11388,1161,61,10.708793247,11205,1.5541143587,3304,1287
2022-2023,10,04,Mauricie et Centre-du-Québec,CIUSSS DE LA MAURICIE-ET-DU-CENTRE-DU-QUÉBEC,PAVILLON SAINTE-MARIE,51220168,46414,9966,2657,11.065609754,34207,3.616088934,25942,2158,733,5.7087026936,13981,5.4077856655,20472,5488,1010,17.853851399,20226,2.3775982783,7808,1924
2022-2023,10,05,Estrie,CIUSSS DE L'ESTRIE - CENTRE HOSPITALIER UNIVERSITAIRE DE SHERBROOKE,CENTRE DE SANTÉ ET DE SERVICES SOCIAUX DU GRANIT,51223832,11735,1845,340,6.4894366331,9628,3.4293316946,9392,1050,191,4.8691889078,7310,3.7995398237,2343,320,43,12.984258074,2318,2.2618504937,795,149
2022-2023,10,05,Estrie,CIUSSS DE L'ESTRIE - CENTRE HOSPITALIER UNIVERSITAIRE DE SHERBROOKE,CENTRE MULTISERVICES DE SANTÉ ET DE SERVICES SOCIAUX DE LA MRC DE COATICOOK,51247617,14738,974,351,2.8865674145,12114,2.0608531451,11912,558,262,2.725139332,9330,2.2227876027,2826,0,0,3.5670102029,2784,1.5181633142,416,89
2022-2023,10,05,Estrie,CIUSSS DE L'ESTRIE - CENTRE HOSPITALIER UNIVERSITAIRE DE SHERBROOKE,CENTRE MULTISERVICES DE SANTÉ ET DE SERVICES SOCIAUX DE MEMPHRÉMAGOG,51219046,17957,3419,606,7.0243714924,15083,2.7756932934,13193,1505,335,4.0492007546,10395,3.0966654642,4764,903,348,15.26354604,4688,2.0639813235,1914,271
2022-2023,10,05,Estrie,CIUSSS DE L'ESTRIE - CENTRE HOSPITALIER UNIVERSITAIRE DE SHERBROOKE,CENTRE MULTISERVICES DE SANTÉ ET DE SERVICES SOCIAUX DES SOURCES,51247583,14606,1459,425,6.277750677,11367,4.4079634761,12933,910,319,5.6234999613,9717,4.7128447566,1673,140,19,11.335386365,1650,2.612489899,549,106
2022-2023,10,05,Estrie,CIUSSS DE L'ESTRIE - CENTRE HOSPITALIER UNIVERSITAIRE DE SHERBROOKE,CHUS - HÔPITAL FLEURIMONT,51216687,37192,4695,759,8.9825016133,31108,2.925180018,20148,854,308,6.0571661373,14068,4.8631113165,17044,2467,211,12.440590041,17040,1.3252494131,3841,451
2022-2023,10,05,Estrie,CIUSSS DE L'ESTRIE - CENTRE HOSPITALIER UNIVERSITAIRE DE SHERBROOKE,CHUS - HÔTEL-DIEU DE SHERBROOKE,51216695,37573,7032,4550,10.808069624,30909,2.8768492456,18520,1462,879,5.4639848812,11894,4.5901000504,19053,4180,1051,16.00265575,19015,1.8052002805,5570,3671
2022-2023,10,05,Estrie,CIUSSS DE L'ESTRIE - CENTRE HOSPITALIER UNIVERSITAIRE DE SHERBROOKE,HÔPITAL BROME-MISSISQUOI-PERKINS,51229185,21976,3274,706,9.8515692624,17119,3.863333382,15804,1155,296,5.4682016156,11026,4.4308722313,6172,1823,700,21.075603982,6093,2.8363050951,2119,410
2022-2023,10,05,Estrie,CIUSSS DE L'ESTRIE - CENTRE HOSPITALIER UNIVERSITAIRE DE SHERBROOKE,HÔPITAL DE GRANBY,51228120,30352,4936,1766,11.284379713,22546,4.8052377485,20696,1668,674,7.2721469259,12961,6.2543621677,9656,3181,682,19.883920907,9585,2.8457070654,3268,1092
2022-2023,10,06,Montréal,CENTRE HOSPITALIER DE L'UNIVERSITÉ DE MONTRÉAL,CENTRE HOSPITALIER DE L'UNIVERSITÉ DE MONTRÉAL,51236297,51714,7257,4215,13.970996249,39855,3.099965953,31077,1923,1573,7.4223675601,19373,4.9044656223,20637,8315,2331,23.832494226,20482,1.3931711042,5334,2642
2022-2023,10,06,Montréal,CENTRE HOSPITALIER UNIVERSITAIRE SAINTE-JUSTINE,CHU SAINTE-JUSTINE,51222800,71823,0,1405,6.2520435384,56706,2.8824770062,48923,0,691,5.6270807073,34887,3.5955405149,22900,517,10,7.5871988476,21819,1.7423401241,0,714
2022-2023,10,06,Montréal,CENTRE UNIVERSITAIRE DE SANTÉ MCGILL,HÔPITAL DE LACHINE,51228310,15020,1508,322,7.2629661377,13471,2.9925080832,12499,724,186,4.3723236748,10971,3.0933905296,2521,755,280,21.594636167,2500,2.5497955556,784,136
2022-2023,10,06,Montréal,CENTRE UNIVERSITAIRE DE SANTÉ MCGILL,HÔPITAL GÉNÉRAL DE MONTRÉAL,51248219,24003,3876,2922,16.940735892,20564,1.8306844756,10295,759,611,5.9807087313,6980,2.7150901783,13708,4309,2184,25.171949754,13584,1.376241616,3117,2311
2022-2023,10,06,Montréal,CENTRE UNIVERSITAIRE DE SANTÉ MCGILL,HÔPITAL ROYAL VICTORIA,51223295,35740,5583,919,17.025531819,27321,4.2398357186,23099,1626,430,8.5683202496,14886,5.41409391,12641,5615,2850,32.479461892,12435,2.83412543,3957,489
2022-2023,10,06,Montréal,CENTRE UNIVERSITAIRE DE SANTÉ MCGILL,L'HÔPITAL DE MONTRÉAL POUR ENFANTS,51223279,62069,3,1811,7.5644844403,49256,2.7430159665,48043,1,538,6.9200094765,35345,3.373646634,14026,807,44,9.7719926882,13911,1.1407126854,2,1273
2022-2023,10,06,Montréal,CIUSSS DE L'EST-DE-L'ÎLE-DE-MONTRÉAL,HÔPITAL MAISONNEUVE-ROSEMONT,12934659,51483,9157,3674,13.102669808,37308,3.5095935709,30994,2218,906,5.7945212604,17100,4.8820666992,20489,7519,2961,24.157809448,20208,2.3482074618,6939,2768
2022-2023,10,06,Montréal,CIUSSS DE L'EST-DE-L'ÎLE-DE-MONTRÉAL,HÔPITAL SANTA CABRINI,51235919,27301,6808,932,13.588174528,21005,2.9711439737,16710,1722,382,4.9954904748,10458,4.1275203991,10591,4043,1926,27.145322155,10547,1.8245255365,5086,550
2022-2023,10,06,Montréal,CIUSSS DE L'EST-DE-L'ÎLE-DE-MONTRÉAL,INSTITUT UNIVERSITAIRE EN SANTÉ MENTALE DE MONTRÉAL,51235307,3467,138,3457,18.695250857,3335,1.541848659,1411,34,1402,3.6712191905,1279,1.7469322822,2056,1112,380,29.006004107,2056,1.4142698876,104,2055
2022-2023,10,06,Montréal,CIUSSS DE L'OUEST-DE-L'ÎLE-DE-MONTRÉAL,CENTRE HOSPITALIER DE ST. MARY,51248243,26238,4917,1834,10.734714473,24249,2.4405273528,17631,1537,668,5.6549305044,15657,2.9311830172,8607,2857,651,21.140392542,8592,1.5464170482,3380,1166
2022-2023,10,06,Montréal,CIUSSS DE L'OUEST-DE-L'ÎLE-DE-MONTRÉAL,HÔPITAL DE LASALLE,51224392,20381,3160,621,9.8637978455,15928,3.2443352726,15385,1190,209,5.547608782,10990,3.8208277727,4996,1636,658,23.155344831,4938,1.9612950587,1970,412
2022-2023,10,06,Montréal,CIUSSS DE L'OUEST-DE-L'ÎLE-DE-MONTRÉAL,HÔPITAL DOUGLAS,51235190,4195,83,4009,10.013639915,3810,2.034507874,2301,37,2125,3.4911542083,1919,1.9975848243,1894,468,93,17.937736859,1891,2.0719776426,46,1884
2022-2023,10,06,Montréal,CIUSSS DE L'OUEST-DE-L'ÎLE-DE-MONTRÉAL,HÔPITAL GÉNÉRAL DU LAKESHORE,51228278,29311,6308,2260,15.092148662,23836,2.6347250191,18698,1798,346,6.9639962236,13253,3.3903637122,10613,4199,2140,29.412340343,10583,1.6884451741,4510,1914
2022-2023,10,06,Montréal,CIUSSS DU CENTRE-OUEST-DE-L'ÎLE-DE-MONTRÉAL,HÔPITAL GÉNÉRAL JUIF,51248250,67632,12628,3612,10.293880781,59115,2.3226462639,26257,1625,426,4.1468640426,18806,2.7944938672,41375,6479,1616,14.194840745,40309,2.1025076837,11003,3186
2022-2023,10,06,Montréal,CIUSSS DU CENTRE-SUD-DE-L'ÎLE-DE-MONTRÉAL,HÔPITAL DE VERDUN,51218097,32039,5116,2153,8.704508611,28303,2.0796255894,21490,1504,853,4.1374964454,17790,2.5978700581,10549,3037,305,18.008242751,10513,1.2026571599,3612,1300
2022-2023,10,06,Montréal,CIUSSS DU CENTRE-SUD-DE-L'ÎLE-DE-MONTRÉAL,HÔPITAL NOTRE-DAME,51236313,28154,3678,4083,13.472429071,23986,2.3859629923,17096,751,1473,5.8458429197,12963,3.3355232199,11058,4342,1466,25.263360237,11023,1.2692842995,2927,2610
2022-2023,10,06,Montréal,CIUSSS DU NORD-DE-L'ÎLE-DE-MONTRÉAL,HÔPITAL DU SACRÉ-COEUR-DE-MONTRÉAL,12475976,49004,9049,2438,12.395131129,39341,3.0814623774,33539,2873,1169,6.6495156882,23922,4.203781108,15465,6537,2343,24.855667583,15419,1.3402269747,6176,1269
2022-2023,10,06,Montréal,CIUSSS DU NORD-DE-L'ÎLE-DE-MONTRÉAL,HÔPITAL EN SANTÉ MENTALE ALBERT-PRÉVOST,51848752,2709,122,2699,20.962332041,2679,0.3390403758,1214,37,1205,3.9665984807,1184,0.4559016047,1495,948,352,34.763549796,1495,0.2464894091,85,1494
2022-2023,10,06,Montréal,CIUSSS DU NORD-DE-L'ÎLE-DE-MONTRÉAL,HÔPITAL FLEURY,51228492,24410,3913,822,9.9860324207,17693,3.8074342803,18146,1501,409,5.9842619892,11458,4.7577483466,6264,2415,305,21.578645168,6235,2.0610511895,2412,413
2022-2023,10,06,Montréal,CIUSSS DU NORD-DE-L'ÎLE-DE-MONTRÉAL,HÔPITAL JEAN-TALON,51228500,31853,3891,2454,8.0403172822,23828,3.4936957921,23738,1103,992,5.3370728251,15750,4.4699708995,8115,1912,95,15.947848634,8078,1.5902131303,2788,1462
2022-2023,10,06,Montréal,INSTITUT DE CARDIOLOGIE DE MONTRÉAL,INSTITUT DE CARDIOLOGIE DE MONTRÉAL,51248201,14203,3976,432,9.135502828,13805,1.3009667592,8733,1624,366,3.6922737191,8342,1.5203072471,5470,1454,172,17.825762391,5463,0.9660338743,2352,66
2022-2023,10,07,Outaouais,CISSS DE L'OUTAOUAIS,CENTRE MULTISERVICES DE SANTÉ ET DE SERVICES SOCIAUX DE MANSFIELD-ET-PONTEFRACT,51245058,8325,864,196,4.0939186854,7811,1.5625577533,8102,806,189,3.9548956362,7589,1.5672115708,223,7,1,9.1448816642,222,1.4034684685,58,7
2022-2023,10,07,Outaouais,CISSS DE L'OUTAOUAIS,CLSC ET CENTRE D'HÉBERGEMENT DE LA PETITE-NATION,51219491,9248,1095,298,3.0000643382,7466,1.4752894976,8658,897,276,2.8642600613,6877,1.538283974,590,0,0,4.9929345574,589,0.7397835314,198,22
2022-2023,10,07,Outaouais,CISSS DE L'OUTAOUAIS,HÔPITAL DE GATINEAU,51221703,29636,3686,3363,11.975444523,18615,3.9107579013,19447,1377,923,5.4067511556,8679,4.4905843287,10189,3304,1583,24.512629715,9936,3.4042851192,2309,2440
2022-2023,10,07,Outaouais,CISSS DE L'OUTAOUAIS,HÔPITAL DE HULL,51221711,26013,4357,918,12.669534827,17286,3.2091324547,17428,1364,598,4.9541364152,8856,3.7274271053,8585,3002,1683,28.33219802,8430,2.6646464017,2993,320
2022-2023,10,07,Outaouais,CISSS DE L'OUTAOUAIS,HÔPITAL DE MANIWAKI,51221893,10853,1419,527,6.696383514,9464,2.6439776756,7245,617,270,3.8325348516,5991,2.7695357852,3608,486,201,12.447099578,3473,2.4273872253,802,257
2022-2023,10,07,Outaouais,CISSS DE L'OUTAOUAIS,HÔPITAL ET CHSLD DE PAPINEAU,51228823,17395,2042,776,9.1453348983,12248,3.4766987581,13255,853,325,3.8589920365,8158,3.6907997603,4140,1454,758,26.070570317,4090,3.0496483972,1189,451
2022-2023,10,07,Outaouais,CISSS DE L'OUTAOUAIS,HÔPITAL ET CHSLD DU PONTIAC,51219459,8585,921,239,5.6848417459,7748,2.2030659884,6679,556,156,4.1380200379,5857,2.2273657352,1906,216,70,11.105210155,1891,2.1278023092,365,83
2022-2023,10,07,Outaouais,CISSS DE L'OUTAOUAIS,HÔPITAL ET CHSLD MÉMORIAL DE WAKEFIELD / WAKEFIELD MEMORIAL HOSPITAL,51228799,13021,895,332,5.5727310797,10320,3.1409150248,11388,596,244,4.4371223608,8723,3.2225658222,1633,262,57,13.492089372,1597,2.6949288597,299,88
2022-2023,10,08,Abitibi-Témiscamingue,CISSS DE L'ABITIBI-TÉMISCAMINGUE,CENTRE MULTISERVICES DE SANTÉ ET DE SERVICES SOCIAUX DE LA SARRE,51247559,14477,1732,623,6.1349967957,12850,2.5067088413,12182,1041,482,4.6391370009,10583,2.6492697933,2295,311,137,14.075111837,2267,1.8411938195,691,141
2022-2023,10,08,Abitibi-Témiscamingue,CISSS DE L'ABITIBI-TÉMISCAMINGUE,CENTRE MULTISERVICES DE SANTÉ ET DE SERVICES SOCIAUX DE TÉMISCAMING-KIPAWA,51247476,3797,291,217,2.5691383548,3664,0.8979623817,3754,279,210,2.4585462914,3622,0.8988756979,43,4,0,12.224082687,42,0.8191997354,12,7
2022-2023,10,08,Abitibi-Témiscamingue,CISSS DE L'ABITIBI-TÉMISCAMINGUE,CENTRE MULTISERVICES DE SANTÉ ET DE SERVICES SOCIAUX DE VILLE-MARIE,51247542,9255,1165,533,5.3133182064,7919,2.9783798459,8020,761,406,4.598257412,6706,3.0633166402,1235,63,2,9.9568708952,1213,2.5088117157,404,127
2022-2023,10,08,Abitibi-Témiscamingue,CISSS DE L'ABITIBI-TÉMISCAMINGUE,HÔPITAL D'AMOS,51228906,17557,1703,691,4.5246077538,15690,1.5947461405,13542,703,524,2.8223148148,11710,1.7677024386,4015,382,51,10.266189567,3980,1.0858722083,1000,167
2022-2023,10,08,Abitibi-Témiscamingue,CISSS DE L'ABITIBI-TÉMISCAMINGUE,HÔPITAL DE ROUYN-NORANDA,51228922,21578,2458,1161,7.096643083,16144,3.9201948608,17636,1205,736,6.0319309147,12249,4.4267200724,3942,409,21,11.860028116,3895,2.3272738554,1253,425
2022-2023,10,08,Abitibi-Témiscamingue,CISSS DE L'ABITIBI-TÉMISCAMINGUE,HÔPITAL DE VAL-D'OR,51225589,21909,2166,1440,7.4606079059,17397,4.159747003,17967,1137,1028,5.7894146213,13462,4.7744291958,3942,808,116,15.077637268,3935,2.0568622053,1029,412
2022-2023,10,09,Côte-Nord,CISSS DE LA CÔTE-NORD,CENTRE MULTISERVICES DE SANTÉ ET DE SERVICES SOCIAUX DE FERMONT,51245108,4998,33,239,9.0748827309,4047,2.0768392225,4787,31,229,9.2109805492,3836,2.1158016887,211,2,1,5.9872037915,211,1.3684978936,2,10
2022-2023,10,09,Côte-Nord,CISSS DE LA CÔTE-NORD,CENTRE MULTISERVICES DE SANTÉ ET DE SERVICES SOCIAUX DE FORESTVILLE,51218741,8652,1215,351,3.2634573573,7278,1.9266377363,7797,944,299,2.8934272797,6497,2.0262037607,855,27,0,6.6378719948,781,1.0983656992,271,52
2022-2023,10,09,Côte-Nord,CISSS DE LA CÔTE-NORD,CENTRE MULTISERVICES DE SANTÉ ET DE SERVICES SOCIAUX DE LA BASSE-CÔTE-NORD,51245140,2770,357,115,3.247555355,2651,1.2209306761,2239,251,101,3.0249652623,2125,1.2449690196,531,0,0,4.1861226198,526,1.1238175961,106,14
2022-2023,10,09,Côte-Nord,CISSS DE LA CÔTE-NORD,CENTRE MULTISERVICES DE SANTÉ ET DE SERVICES SOCIAUX DE LA MINGANIE,51245116,10107,925,291,3.0581402603,5625,2.5118306667,6989,608,124,1.8404883468,2631,2.652891275,3118,67,3,5.7875081961,2994,2.387872597,317,167
2022-2023,10,09,Côte-Nord,CISSS DE LA CÔTE-NORD,CENTRE MULTISERVICES DE SANTÉ ET DE SERVICES SOCIAUX DE PORT-CARTIER,51245132,10871,803,453,5.3633309825,8983,2.916903472,9837,587,375,4.3379541527,7970,3.099009724,1034,181,54,15.118294111,1013,1.4841425359,216,78
2022-2023,10,09,Côte-Nord,CISSS DE LA CÔTE-NORD,CENTRE MULTISERVICES DE SANTÉ ET DE SERVICES SOCIAUX DES ESCOUMINS,51218733,7854,1065,248,3.5723503593,6931,1.5965170971,6956,717,213,3.0058663983,6044,1.6755793625,898,25,1,7.9603931576,887,1.0577884254,348,35
2022-2023,10,09,Côte-Nord,CISSS DE LA CÔTE-NORD,CLSC ET HÔPITAL LE ROYER,51228765,17387,2541,1140,9.6763125387,14845,3.6004546798,12978,1063,686,5.5163598654,10441,4.1538065745,4409,1266,603,21.921235604,4404,2.28856841,1478,454
2022-2023,10,09,Côte-Nord,CISSS DE LA CÔTE-NORD,HÔPITAL ET CLSC DE SEPT-ÎLES,51232023,16659,1677,1007,9.4620561792,12638,4.0402184329,11543,596,464,5.3088603483,7665,4.4137800609,5116,1201,445,18.832724568,4973,3.4644392497,1081,543
2022-2023,10,11,Gaspésie-Îles-de-la-Madeleine,CISSS DE LA GASPÉSIE,CENTRE MULTISERVICES DE SANTÉ ET DE SERVICES SOCIAUX DE GRANDE-VALLÉE,51247732,4997,895,95,1.9978249172,3980,0.9267332496,4510,701,83,1.5673282212,3540,0.9549053672,487,22,4,5.9845602327,440,0.7000757576,194,12
2022-2023,10,11,Gaspésie-Îles-de-la-Madeleine,CISSS DE LA GASPÉSIE,CLSC ET CENTRE DE SERVICES AMBULATOIRES DE MURDOCHVILLE,51221307,1546,157,81,3.1271390326,1505,1.4974913252,1501,146,81,3.0317614183,1460,1.5271767504,45,3,0,6.3085123457,45,0.5343641975,11,0
2022-2023,10,11,Gaspésie-Îles-de-la-Madeleine,CISSS DE LA GASPÉSIE,CLSC ET CENTRE DE SERVICES AMBULATOIRES DE PASPÉBIAC,51220978,10776,1807,371,4.2494647571,9598,2.0605508381,8420,1103,296,3.4234310504,7361,2.1911906972,2356,117,18,7.2015886154,2237,1.6306715343,704,75
2022-2023,10,11,Gaspésie-Îles-de-la-Madeleine,CISSS DE LA GASPÉSIE,HÔPITAL DE CHANDLER,51227775,12515,1983,498,5.8922859458,10750,2.2578808786,10543,1270,383,4.2001526816,8786,2.4527810026,1972,358,58,14.939020735,1964,1.3859906087,713,115
2022-2023,10,11,Gaspésie-Îles-de-la-Madeleine,CISSS DE LA GASPÉSIE,HÔPITAL DE GASPÉ,51220903,11292,1826,500,5.0166013549,9727,1.7238437682,9125,1074,314,3.6201253272,7592,1.9575525773,2167,190,6,10.897009178,2135,0.8927818111,752,186
2022-2023,10,11,Gaspésie-Îles-de-la-Madeleine,CISSS DE LA GASPÉSIE,HÔPITAL ET CLSC DE SAINTE-ANNE-DES-MONTS,51247799,10793,1798,487,5.4683421611,9279,2.1939163703,8509,980,328,3.2625324493,7045,2.3049004416,2284,367,130,13.68604568,2234,1.8439240774,818,159
2022-2023,10,11,Gaspésie-Îles-de-la-Madeleine,CISSS DE LA GASPÉSIE,HÔPITAL ET GROUPE DE MÉDECINE DE FAMILLE UNIVERSITAIRE DE MARIA,51227908,12926,2203,666,9.0000821772,11899,2.1694906902,9643,1077,339,4.0990918283,8632,2.4034711281,3283,1112,525,23.395528395,3267,1.5512724042,1126,327
2022-2023,10,11,Gaspésie-Îles-de-la-Madeleine,CISSS DES ÎLES,HÔPITAL DE L'ARCHIPEL,51227783,13590,1658,364,4.4996154648,11893,1.9075550511,11539,1147,224,3.3338401652,9856,2.0301284046,2051,211,18,11.058309361,2037,1.3144853543,511,140
2022-2023,10,12,Chaudière-Appalaches,CISSS DE CHAUDIÈRE-APPALACHES,CHSLD ET HÔPITAL PAUL-GILBERT,51245199,37060,2519,501,2.6598679169,27469,2.0367605301,35325,2363,479,2.6156436581,25736,2.1230114323,1735,0,0,3.5602840218,1733,0.7558873501,156,22
2022-2023,10,12,Chaudière-Appalaches,CISSS DE CHAUDIÈRE-APPALACHES,HÔPITAL DE MONTMAGNY,51245223,26887,3993,822,4.5582311361,24554,1.5112667658,21123,1940,440,2.521440018,18792,1.7399521368,5764,680,48,12.022342654,5762,0.7654397104,2053,382
2022-2023,10,12,Chaudière-Appalaches,CISSS DE CHAUDIÈRE-APPALACHES,HÔPITAL DE SAINT-GEORGES,51228971,34211,5886,1669,7.189526801,27724,2.544884296,24044,2116,800,4.1992945803,17596,3.1919246167,10167,1902,148,14.261145126,10128,1.4207411796,3770,869
2022-2023,10,12,Chaudière-Appalaches,CISSS DE CHAUDIÈRE-APPALACHES,HÔPITAL DE THETFORD,51245231,30679,4585,910,6.7032814158,27695,1.7223800325,24463,2358,491,4.5564239532,21484,1.9371933635,6216,1298,190,15.152215474,6211,0.979335498,2227,419
2022-2023,10,12,Chaudière-Appalaches,CISSS DE CHAUDIÈRE-APPALACHES,HÔTEL-DIEU DE LÉVIS,51227569,60509,10985,3803,8.0146610146,54285,1.3618963444,42308,4098,1864,3.2843028899,36088,1.7216979867,18201,5371,1317,19.010320129,18197,0.6483434693,6887,1939
2022-2023,10,13,Laval,CISSS DE LAVAL,HÔPITAL DE LA CITÉ-DE-LA-SANTÉ,51228757,72579,12180,4414,9.3561265885,53907,3.2350124546,48347,3474,1290,5.5735865261,29766,4.1724498216,24232,5611,454,16.902943376,24141,2.0791464728,8706,3124
2022-2023,10,14,Lanaudière,CISSS DE LANAUDIÈRE,HÔPITAL DE LANAUDIÈRE ET CENTRE D'HÉBERGEMENT PARPHILIA-FERLAND,51244945,53379,8581,3358,10.275529578,42953,2.5894273715,35412,2423,2391,5.6231494346,25093,3.4123057227,17967,5298,1774,19.445123034,17860,1.4332971102,6158,967
2022-2023,10,14,Lanaudière,CISSS DE LANAUDIÈRE,HÔPITAL PIERRE-LE GARDEUR,51228062,59473,9869,3320,11.612770903,36450,5.5995610273,41000,3330,1187,7.0169207385,18047,7.3147592244,18473,7052,1267,21.813055465,18403,3.9175427768,6539,2133
2022-2023,10,15,Laurentides,CISSS DES LAURENTIDES,CENTRE MULTISERVICES DE SANTÉ ET DE SERVICES SOCIAUX D'ARGENTEUIL,51245306,16216,1960,532,9.5849339815,12684,3.8762796524,13397,1080,344,6.0842070571,9880,4.4171151035,2819,1134,493,26.221769244,2804,1.9706254953,880,188
2022-2023,10,15,Laurentides,CISSS DES LAURENTIDES,CENTRE MULTISERVICES DE SANTÉ ET DE SERVICES SOCIAUX DE RIVIÈRE-ROUGE,51217628,11643,1146,548,6.2491027274,10017,2.9510400098,9404,642,297,4.0569411362,7817,3.100675522,2239,422,131,15.456377227,2200,2.4193578283,504,251
2022-2023,10,15,Laurentides,CISSS DES LAURENTIDES,CENTRE MULTISERVICES DE SANTÉ ET DE SERVICES SOCIAUX DE SAINTE-AGATHE,51246874,23645,4199,1303,12.550585184,18704,4.1248439876,15661,1561,388,6.8860650838,10788,5.2069977959,7984,2896,970,23.661813801,7916,2.6500744975,2638,915
2022-2023,10,15,Laurentides,CISSS DES LAURENTIDES,HÔPITAL DE MONT-LAURIER,51217610,13362,1783,679,9.742280867,10710,3.0980737628,10235,844,370,5.8601958964,7623,3.3371302491,3127,986,380,22.44875342,3087,2.5077506029,939,309
2022-2023,10,15,Laurentides,CISSS DES LAURENTIDES,HÔPITAL DE SAINT-EUSTACHE,51228864,38731,6904,2115,13.203675817,26722,3.8150879217,23973,1850,628,7.0742407778,12042,5.643537503,14758,5640,1908,23.16037362,14680,2.3152112284,5054,1487
2022-2023,10,15,Laurentides,CISSS DES LAURENTIDES,HÔPITAL DE SAINT-JÉRÔME,51228880,45163,7510,4219,14.916975695,30479,5.0427957956,26740,2212,1170,7.2927067647,12213,7.0602579674,18423,7079,2759,25.983194618,18266,3.6938816654,5298,3049
2022-2023,10,16,Montérégie,CISSS DE LA MONTÉRÉGIE-CENTRE,HÔPITAL CHARLES-LE MOYNE,51233799,60621,9782,4678,9.9441670012,32461,5.3274569911,43457,3728,1975,6.0950469366,15309,6.3921908137,17164,5570,597,19.689634879,17152,4.3771299103,6054,2703
2022-2023,10,16,Montérégie,CISSS DE LA MONTÉRÉGIE-CENTRE,HÔPITAL DU HAUT-RICHELIEU,51229045,49033,7056,2758,10.276155146,35313,3.0758454158,35467,2529,1021,5.0415894431,21849,3.6923630499,13566,4164,2436,23.961422859,13464,2.0753779626,4527,1737
2022-2023,10,16,Montérégie,CISSS DE LA MONTÉRÉGIE-EST,HÔPITAL HONORÉ-MERCIER,51229193,35829,6713,2086,11.065425237,26000,4.4266799145,26055,2689,1054,6.1687587155,16245,5.5791871858,9774,3686,1470,24.118693728,9755,2.5074097329,4024,1032
2022-2023,10,16,Montérégie,CISSS DE LA MONTÉRÉGIE-EST,HÔPITAL PIERRE-BOUCHER,51229011,43246,8366,2673,14.01868474,31309,4.7755592552,21868,2407,799,6.2965742688,10165,6.2226973001,21378,6255,2730,21.91779185,21144,4.0798461344,5959,1874
2022-2023,10,16,Montérégie,CISSS DE LA MONTÉRÉGIE-EST,HÔTEL-DIEU DE SOREL,51229102,27617,4130,1272,9.1593864789,23334,2.5253264788,19201,1627,400,4.9395992107,14976,3.026244213,8416,2358,735,18.786778986,8358,1.6277739558,2503,872
2022-2023,10,16,Montérégie,CISSS DE LA MONTÉRÉGIE-OUEST,HÔPITAL ANNA-LABERGE,51229151,29192,5775,1589,18.137107503,21301,2.2283140072,19317,1857,451,8.8024525317,11428,3.1396890678,9875,5150,2690,36.397110549,9873,1.1733971437,3918,1138
2022-2023,10,16,Montérégie,CISSS DE LA MONTÉRÉGIE-OUEST,HÔPITAL BARRIE MEMORIAL / BARRIE MEMORIAL HOSPITAL,51228005,17234,1642,285,5.8516658769,13604,3.3581957104,14625,915,216,4.1696626781,11010,3.0535475325,2609,548,52,15.280296303,2594,4.6512475371,727,69
2022-2023,10,16,Montérégie,CISSS DE LA MONTÉRÉGIE-OUEST,HÔPITAL DU SUROÎT,51229136,29200,5567,2083,14.333065373,23066,2.2528878484,19341,1628,1210,4.4876780759,13247,2.9490771705,9859,4026,2369,33.647360505,9819,1.3136455681,3939,873
2023-2024,10,01,Bas-Saint-Laurent,CISSS DU BAS-SAINT-LAURENT,CENTRE HOSPITALIER RÉGIONAL DU GRAND-PORTAGE,51218352,15974,3027,867,5.2015225957,13605,2.2332596472,11579,1304,484,3.538113323,9235,2.5066340612,4395,99,2,9.5839153078,4370,1.6555450674,1723,383
2023-2024,10,01,Bas-Saint-Laurent,CISSS DU BAS-SAINT-LAURENT,CENTRE MULTISERVICES DE SANTÉ ET DE SERVICES SOCIAUX DE TROIS-PISTOLES,51236156,8641,1344,225,3.3688925214,7889,1.4122468698,7342,867,167,2.5016145313,6618,1.507928629,1299,43,1,8.2707824395,1271,0.9140392517,477,58
2023-2024,10,01,Bas-Saint-Laurent,CISSS DU BAS-SAINT-LAURENT,CLSC DE POHÉNÉGAMOOK,51219418,8141,1059,263,1.788174262,7567,0.8827533295,7646,913,245,1.4867695527,7073,0.8942385755,495,7,0,6.4438114478,494,0.7183097166,146,18
2023-2024,10,01,Bas-Saint-Laurent,CISSS DU BAS-SAINT-LAURENT,HÔPITAL D'AMQUI,51226892,11600,1907,379,4.4743960967,10201,1.8971870133,6446,660,203,3.5675645965,5254,2.2064693567,5154,80,4,5.608551287,4947,1.5687112841,1247,176
2023-2024,10,01,Bas-Saint-Laurent,CISSS DU BAS-SAINT-LAURENT,HÔPITAL DE MATANE,51218980,13146,2300,541,5.5228121355,11542,2.7509411281,9615,1060,311,4.6619567805,8097,3.1553132848,3531,137,10,7.8669424777,3445,1.8005198355,1240,230
2023-2024,10,01,Bas-Saint-Laurent,CISSS DU BAS-SAINT-LAURENT,HÔPITAL DE NOTRE-DAME-DU-LAC,51221877,9830,1791,276,3.5202783147,8840,1.4072806373,7770,1026,146,2.3418899971,6804,1.5782574384,2060,52,0,7.9649759978,2036,0.8359023685,765,130
2023-2024,10,01,Bas-Saint-Laurent,CISSS DU BAS-SAINT-LAURENT,HÔPITAL NOTRE-DAME-DE-FATIMA,51221141,12882,2366,432,4.0432361693,11873,1.6921613231,10089,1244,216,2.9421891279,9100,1.8438844933,2793,39,4,8.0204877273,2773,1.1942598269,1122,216
2023-2024,10,01,Bas-Saint-Laurent,CISSS DU BAS-SAINT-LAURENT,HÔPITAL RÉGIONAL DE RIMOUSKI,51227882,23705,4380,1249,6.422482458,18881,2.5502492217,16895,1811,703,4.2636094012,12129,2.9898028142,6810,740,120,11.778453133,6752,1.7606542095,2569,546
2023-2024,10,02,Saguenay-Lac-Saint-Jean,CIUSSS DU SAGUENAY - LAC-SAINT-JEAN,HÔPITAL D'ALMA,51219400,26802,4072,1002,4.8942090557,21184,2.8763868171,20520,2175,477,3.7659240308,15025,3.0967997412,6282,130,0,8.57972461,6159,2.3386852122,1897,525
2023-2024,10,02,Saguenay-Lac-Saint-Jean,CIUSSS DU SAGUENAY - LAC-SAINT-JEAN,HÔPITAL DE CHICOUTIMI,51218394,41925,6784,2778,7.4972727092,36638,2.5236431058,24024,2079,929,3.9932485917,18900,3.3381825397,17901,2378,189,12.199841024,17738,1.6557439458,4705,1849
2023-2024,10,02,Saguenay-Lac-Saint-Jean,CIUSSS DU SAGUENAY - LAC-SAINT-JEAN,HÔPITAL DE DOLBEAU-MISTASSINI,51219384,15901,2664,533,4.2725947355,14369,1.8078406639,13278,1729,292,2.9681174792,11775,1.9439055909,2623,234,42,10.876044605,2594,1.1901982138,935,241
2023-2024,10,02,Saguenay-Lac-Saint-Jean,CIUSSS DU SAGUENAY - LAC-SAINT-JEAN,HÔPITAL DE LA BAIE,51221364,14291,1845,488,5.3409301697,12953,2.6787527986,11098,843,294,4.0889687832,9787,2.9678923572,3193,111,1,9.6924076104,3166,1.784940777,1002,194
2023-2024,10,02,Saguenay-Lac-Saint-Jean,CIUSSS DU SAGUENAY - LAC-SAINT-JEAN,HÔPITAL ET CENTRE D'HÉBERGEMENT DE ROBERVAL,51228203,18219,2685,1171,5.7122444823,16453,2.1665118317,12374,1099,399,3.3496557298,10723,2.3756118727,5845,570,66,10.713899439,5730,1.7752064669,1586,772
2023-2024,10,02,Saguenay-Lac-Saint-Jean,CIUSSS DU SAGUENAY - LAC-SAINT-JEAN,HÔPITAL ET CENTRE DE RÉADAPTATION DE JONQUIÈRE,51224541,20144,3730,1053,7.7794482366,15866,4.1968238336,12173,1320,403,5.0467829532,8188,4.615944302,7971,657,12,11.95266797,7678,3.7498638968,2410,650
2023-2024,10,03,Capitale-Nationale,CHU DE QUÉBEC - UNIVERSITÉ LAVAL,CENTRE HOSPITALIER DE L'UNIVERSITÉ LAVAL,51217594,56084,4825,5254,8.4114308696,45264,2.264593275,31312,929,1696,4.9860300719,20585,3.4982741613,24772,2818,961,12.741164027,24679,1.2355677454,3896,3558
2023-2024,10,03,Capitale-Nationale,CHU DE QUÉBEC - UNIVERSITÉ LAVAL,HÔPITAL DE L'ENFANT-JÉSUS,51233914,48033,8179,5905,10.238519004,43366,1.6720381943,26991,2716,1560,4.0838932422,22455,2.0793047206,21042,5070,1309,18.133182247,20911,1.2347004368,5463,4345
2023-2024,10,03,Capitale-Nationale,CHU DE QUÉBEC - UNIVERSITÉ LAVAL,HÔPITAL DU SAINT-SACREMENT,51217529,27219,6351,734,7.8772139866,22537,2.0315060296,19100,2491,289,3.6229533886,14457,2.3761969404,8119,2235,420,17.885389553,8080,1.4147737899,3860,445
2023-2024,10,03,Capitale-Nationale,CHU DE QUÉBEC - UNIVERSITÉ LAVAL,HÔPITAL SAINT-FRANÇOIS D'ASSISE,51217602,32317,8073,1033,10.418425244,26285,2.3710122482,19358,2332,501,4.7416146497,13365,3.2054916448,12959,3948,617,18.898377361,12920,1.5077911077,5741,532
2023-2024,10,03,Capitale-Nationale,CHU DE QUÉBEC - UNIVERSITÉ LAVAL,L'HÔTEL-DIEU DE QUÉBEC,51217586,16680,3880,786,7.5886335931,14977,1.602546219,8661,852,278,3.2926817535,7038,1.8556277825,8019,906,15,12.228518726,7939,1.3781869743,3028,508
2023-2024,10,03,Capitale-Nationale,CIUSSS DE LA CAPITALE-NATIONALE,CENTRE MULTISERVICES DE SANTÉ ET DE SERVICES SOCIAUX CHAUVEAU,51225001,31404,2187,422,3.040986985,21427,1.914321391,27697,1768,329,2.8442315353,17791,2.0832735653,3707,0,0,4.5110532626,3636,1.0876359858,419,93
2023-2024,10,03,Capitale-Nationale,CIUSSS DE LA CAPITALE-NATIONALE,CENTRE MULTISERVICES DE SANTÉ ET DE SERVICES SOCIAUX DE BAIE-SAINT-PAUL,51244804,9499,1742,276,5.3051948743,7347,2.0916930947,7695,1101,118,3.1310653021,5556,2.3033908287,1804,296,64,14.578990361,1791,1.4349691358,641,158
2023-2024,10,03,Capitale-Nationale,CIUSSS DE LA CAPITALE-NATIONALE,CENTRE MULTISERVICES DE SANTÉ ET DE SERVICES SOCIAUX DE SAINT-MARC-DES-CARRIÈRES,51247344,13377,1741,305,3.0130688454,11193,1.5535722475,10860,942,202,2.3292368017,8755,1.7674376229,2517,44,7,5.9635718227,2438,0.785569228,799,103
2023-2024,10,03,Capitale-Nationale,CIUSSS DE LA CAPITALE-NATIONALE,CENTRE MULTISERVICES DE SANTÉ ET DE SERVICES SOCIAUX DE SAINT-RAYMOND,51247302,15623,2109,295,4.2793549397,12783,2.0670447513,12721,1189,189,3.3325656177,9912,2.3477353208,2902,114,12,8.4296330117,2871,1.0979730253,920,106
2023-2024,10,03,Capitale-Nationale,CIUSSS DE LA CAPITALE-NATIONALE,CENTRE MULTISERVICES DE SANTÉ ET DE SERVICES SOCIAUX DE SAINTE-ANNE-DE-BEAUPRÉ,51225357,12242,1388,158,4.1673771306,9352,2.0439263437,10466,817,109,3.2366279169,7607,2.2220094796,1776,110,12,9.6522990178,1745,1.2676063356,571,49
2023-2024,10,03,Capitale-Nationale,CIUSSS DE LA CAPITALE-NATIONALE,HÔPITAL ET CLSC DE LA MALBAIE,51228690,10706,1983,304,5.8072397358,8782,1.7337201093,8657,1246,170,3.2708528423,6735,1.9803301163,2049,402,124,16.523443414,2047,0.922328611,737,134
2023-2024,10,03,Capitale-Nationale,INSTITUT UNIVERSITAIRE DE CARDIOLOGIE ET DE PNEUMOLOGIE DE QUÉBEC - UNIVERSITÉ LAVAL,INSTITUT UNIVERSITAIRE DE CARDIOLOGIE ET DE PNEUMOLOGIE DE QUÉBEC,51232130,22286,7440,550,8.2175321826,20940,2.1370962008,11645,2571,314,4.1696222747,10328,2.7343844135,10641,1300,6,12.647370626,10612,1.5557927085,4869,236
2023-2024,10,04,Mauricie et Centre-du-Québec,CIUSSS DE LA MAURICIE-ET-DU-CENTRE-DU-QUÉBEC,CENTRE MULTISERVICES DE SANTÉ ET DE SERVICES SOCIAUX AVELLIN-DALCOURT,51233583,16938,2409,431,4.887242197,13695,2.9594404892,14365,1351,229,4.0386143017,11155,3.2749538075,2573,128,17,9.6251122771,2540,1.5737904637,1058,202
2023-2024,10,04,Mauricie et Centre-du-Québec,CIUSSS DE LA MAURICIE-ET-DU-CENTRE-DU-QUÉBEC,CENTRE MULTISERVICES DE SANTÉ ET DE SERVICES SOCIAUX CHRIST-ROI,51246338,16773,1798,505,5.2898254139,13387,3.4709663396,13768,820,350,4.2612830073,10471,3.7375490773,3005,198,36,10.002295249,2916,2.5137002743,978,155
2023-2024,10,04,Mauricie et Centre-du-Québec,CIUSSS DE LA MAURICIE-ET-DU-CENTRE-DU-QUÉBEC,CENTRE MULTISERVICES DE SANTÉ ET DE SERVICES SOCIAUX DE FORTIERVILLE,51219160,9557,866,181,2.5778584342,7380,2.0927597109,8914,765,168,2.4938816593,6743,2.1760564454,643,1,0,3.7420403491,637,1.2110173557,101,13
2023-2024,10,04,Mauricie et Centre-du-Québec,CIUSSS DE LA MAURICIE-ET-DU-CENTRE-DU-QUÉBEC,CENTRE MULTISERVICES DE SANTÉ ET DE SERVICES SOCIAUX DU HAUT-SAINT-MAURICE,51219731,9331,1435,477,5.9754249574,8074,2.7669429307,6933,808,226,4.0254525458,5714,3.0088296776,2398,239,9,11.613105829,2360,2.1812900188,627,251
2023-2024,10,04,Mauricie et Centre-du-Québec,CIUSSS DE LA MAURICIE-ET-DU-CENTRE-DU-QUÉBEC,HÔPITAL DU CENTRE-DE-LA-MAURICIE,51220051,26580,5227,1728,7.6929025583,21248,3.0260374833,16504,1569,378,5.003454129,11226,4.313518469,10076,1086,65,12.09808883,10022,1.5838840662,3658,1350
2023-2024,10,04,Mauricie et Centre-du-Québec,CIUSSS DE LA MAURICIE-ET-DU-CENTRE-DU-QUÉBEC,HÔPITAL SAINTE-CROIX,51228781,31527,4896,1841,8.2897505842,23086,3.5552736387,18214,1324,447,5.7291670479,10247,4.6616130195,13313,1440,35,11.792978146,12839,2.6722874532,3572,1394
2023-2024,10,04,Mauricie et Centre-du-Québec,CIUSSS DE LA MAURICIE-ET-DU-CENTRE-DU-QUÉBEC,HÔTEL-DIEU D'ARTHABASKA,51228039,29144,5255,1547,6.1279939458,24166,2.2349525734,17581,1667,367,3.9332706868,12786,2.8481222952,11563,801,24,9.4649678813,11380,1.5460256786,3588,1180
2023-2024,10,04,Mauricie et Centre-du-Québec,CIUSSS DE LA MAURICIE-ET-DU-CENTRE-DU-QUÉBEC,PAVILLON SAINTE-MARIE,51220168,45415,10442,2634,10.488089991,34754,3.2563897521,24586,2390,761,5.3295399595,14143,4.8064962447,20829,5051,635,16.577105838,20611,2.1927268476,8052,1873
2023-2024,10,05,Estrie,CIUSSS DE L'ESTRIE - CENTRE HOSPITALIER UNIVERSITAIRE DE SHERBROOKE,CENTRE DE SANTÉ ET DE SERVICES SOCIAUX DU GRANIT,51223832,11390,1815,322,5.6692881182,9570,3.2036981888,9248,1049,204,4.4834055712,7452,3.4439613527,2142,154,4,10.789288956,2118,2.358353006,766,118
2023-2024,10,05,Estrie,CIUSSS DE L'ESTRIE - CENTRE HOSPITALIER UNIVERSITAIRE DE SHERBROOKE,CENTRE MULTISERVICES DE SANTÉ ET DE SERVICES SOCIAUX DE LA MRC DE COATICOOK,51247617,15779,1295,407,2.9890723254,12601,2.1776659039,12554,830,296,2.8074087719,9427,2.3669222859,3225,0,0,3.6962364341,3174,1.6155613317,465,111
2023-2024,10,05,Estrie,CIUSSS DE L'ESTRIE - CENTRE HOSPITALIER UNIVERSITAIRE DE SHERBROOKE,CENTRE MULTISERVICES DE SANTÉ ET DE SERVICES SOCIAUX DE MEMPHRÉMAGOG,51219046,18600,3676,616,6.689437276,15826,2.8338039022,13754,1732,291,4.2041797942,11045,3.1466793672,4846,804,240,13.743137525,4781,2.111003335,1944,325
2023-2024,10,05,Estrie,CIUSSS DE L'ESTRIE - CENTRE HOSPITALIER UNIVERSITAIRE DE SHERBROOKE,CENTRE MULTISERVICES DE SANTÉ ET DE SERVICES SOCIAUX DES SOURCES,51247583,13814,1688,455,5.2421810402,11384,3.6294062817,12060,1109,330,4.625589414,9656,3.8846877014,1754,108,4,9.481687888,1728,2.2029031636,579,125
2023-2024,10,05,Estrie,CIUSSS DE L'ESTRIE - CENTRE HOSPITALIER UNIVERSITAIRE DE SHERBROOKE,CHUS - HÔPITAL FLEURIMONT,51216687,35468,5155,835,9.305419909,29918,2.9224168282,18400,981,303,6.4113369565,12856,5.0976962767,17068,2447,160,12.425359347,17062,1.2833714297,4174,532
2023-2024,10,05,Estrie,CIUSSS DE L'ESTRIE - CENTRE HOSPITALIER UNIVERSITAIRE DE SHERBROOKE,CHUS - HÔTEL-DIEU DE SHERBROOKE,51216695,36020,7340,4351,11.527134462,30325,3.0195905469,18066,1887,960,5.9172580169,12401,4.6598957073,17954,4202,1139,17.172006238,17924,1.8847197426,5453,3391
2023-2024,10,05,Estrie,CIUSSS DE L'ESTRIE - CENTRE HOSPITALIER UNIVERSITAIRE DE SHERBROOKE,HÔPITAL BROME-MISSISQUOI-PERKINS,51229185,21232,3456,721,9.5285405808,17138,3.9354240414,14764,1167,293,5.5633821194,10747,4.511835215,6468,1799,471,18.579499072,6391,2.9661405362,2289,428
2023-2024,10,05,Estrie,CIUSSS DE L'ESTRIE - CENTRE HOSPITALIER UNIVERSITAIRE DE SHERBROOKE,HÔPITAL DE GRANBY,51228120,28529,4909,1928,11.542995315,22198,4.7268080082,19291,1866,754,7.270377954,13009,6.01861141,9238,3167,699,20.465171273,9189,2.8979832771,3043,1174
2023-2024,10,06,Montréal,CENTRE HOSPITALIER DE L'UNIVERSITÉ DE MONTRÉAL,CENTRE HOSPITALIER DE L'UNIVERSITÉ DE MONTRÉAL,51236297,56673,8396,4327,12.828658709,42269,3.189006686,33350,2280,1338,7.5662190571,19128,5.2484011223,23323,7713,1354,20.353520964,23141,1.4867424461,6116,2989
2023-2024,10,06,Montréal,CENTRE HOSPITALIER UNIVERSITAIRE SAINTE-JUSTINE,CHU SAINTE-JUSTINE,51222800,60283,0,1340,5.2433789054,52125,1.9502108766,38186,0,570,4.4457474962,30672,2.524775338,22097,351,4,6.6217720354,21453,1.1287387674,0,770
2023-2024,10,06,Montréal,CENTRE UNIVERSITAIRE DE SANTÉ MCGILL,HÔPITAL DE LACHINE,51228310,15542,1341,283,6.9335637127,13094,3.8018572968,13365,880,192,5.2035986407,10942,3.9589301671,2177,460,158,17.554134768,2152,3.0032089013,461,91
2023-2024,10,06,Montréal,CENTRE UNIVERSITAIRE DE SANTÉ MCGILL,HÔPITAL GÉNÉRAL DE MONTRÉAL,51248219,25067,3777,3263,17.272582712,21572,1.709836877,10527,756,691,5.9507071499,7154,2.4981002081,14540,4489,2187,25.469651765,14418,1.3187121808,3021,2572
2023-2024,10,06,Montréal,CENTRE UNIVERSITAIRE DE SANTÉ MCGILL,HÔPITAL ROYAL VICTORIA,51223295,35763,5959,909,17.728465243,26861,4.3847253143,21678,1680,373,8.8264626452,13123,5.7710253414,14085,5953,2926,31.429396186,13738,3.0604848676,4279,536
2023-2024,10,06,Montréal,CENTRE UNIVERSITAIRE DE SANTÉ MCGILL,L'HÔPITAL DE MONTRÉAL POUR ENFANTS,51223279,53174,5,1638,5.7870742228,49724,1.4821175109,41066,1,510,4.5729600251,37636,1.6854077361,12108,862,50,9.9049147946,12088,0.8491731929,4,1128
2023-2024,10,06,Montréal,CIUSSS DE L'EST-DE-L'ÎLE-DE-MONTRÉAL,HÔPITAL MAISONNEUVE-ROSEMONT,12934659,49898,8838,3183,11.646954855,37972,3.1896560916,29744,2226,769,5.3841815997,17942,4.4555692416,20154,6676,1752,20.889781474,20030,2.0557063294,6612,2414
2023-2024,10,06,Montréal,CIUSSS DE L'EST-DE-L'ÎLE-DE-MONTRÉAL,HÔPITAL SANTA CABRINI,51235919,27047,6708,966,13.780247245,20965,3.2277516098,15770,1735,366,6.1842198619,9733,4.7131255922,11277,4213,1593,24.402695752,11232,1.9406126345,4973,600
2023-2024,10,06,Montréal,CIUSSS DE L'EST-DE-L'ÎLE-DE-MONTRÉAL,INSTITUT UNIVERSITAIRE EN SANTÉ MENTALE DE MONTRÉAL,51235307,3802,169,3792,13.106844716,3732,1.5155635941,1814,64,1807,3.5284186267,1744,1.4881817023,1988,683,169,21.846917617,1988,1.5395847306,105,1985
2023-2024,10,06,Montréal,CIUSSS DE L'OUEST-DE-L'ÎLE-DE-MONTRÉAL,CENTRE HOSPITALIER DE ST. MARY,51248243,25306,5231,1843,12.055847032,23028,2.5559194483,16553,1740,653,5.8318784443,14297,3.0990722801,8753,3203,1001,23.826137451,8731,1.6665074638,3491,1190
2023-2024,10,06,Montréal,CIUSSS DE L'OUEST-DE-L'ÎLE-DE-MONTRÉAL,HÔPITAL DE LASALLE,51224392,20364,3200,679,10.741226756,16091,3.573797896,15392,1311,219,6.1957562731,11152,4.2796244819,4972,1712,740,24.812803924,4939,1.9800789071,1889,460
2023-2024,10,06,Montréal,CIUSSS DE L'OUEST-DE-L'ÎLE-DE-MONTRÉAL,HÔPITAL DOUGLAS,51235190,4470,104,4321,14.543698732,4126,2.1546123499,2350,46,2221,3.8256359338,2009,2.1628373707,2120,934,272,26.424570231,2117,2.1468069333,58,2100
2023-2024,10,06,Montréal,CIUSSS DE L'OUEST-DE-L'ÎLE-DE-MONTRÉAL,HÔPITAL GÉNÉRAL DU LAKESHORE,51228278,29024,6668,2108,15.445607658,24041,2.5967537517,18042,1926,287,7.0287155588,13103,3.3093756095,10982,4473,2102,29.273468453,10938,1.7430799354,4742,1821
2023-2024,10,06,Montréal,CIUSSS DU CENTRE-OUEST-DE-L'ÎLE-DE-MONTRÉAL,HÔPITAL GÉNÉRAL JUIF,51248250,69057,13433,3803,11.225416134,59085,2.5864841424,24934,1681,400,4.1390847058,16241,3.1148900246,44123,7364,2134,15.229916912,42844,2.386179784,11752,3403
2023-2024,10,06,Montréal,CIUSSS DU CENTRE-SUD-DE-L'ÎLE-DE-MONTRÉAL,HÔPITAL DE VERDUN,51218097,32794,5841,2039,9.6304517933,28312,2.2537665615,21542,1825,753,4.4347807642,17085,2.8723058726,11252,3834,483,19.577585219,11227,1.3124871342,4016,1286
2023-2024,10,06,Montréal,CIUSSS DU CENTRE-SUD-DE-L'ÎLE-DE-MONTRÉAL,HÔPITAL NOTRE-DAME,51236313,29356,4168,4429,13.390703443,24479,2.2934680406,17323,920,1652,5.7286807199,12491,3.2271047376,12033,4594,1407,24.421138051,11988,1.3206572313,3248,2777
2023-2024,10,06,Montréal,CIUSSS DU NORD-DE-L'ÎLE-DE-MONTRÉAL,HÔPITAL DU SACRÉ-COEUR-DE-MONTRÉAL,12475976,49366,9593,2254,12.896385862,38405,3.354649561,33516,3080,949,7.0754068869,22589,4.6966904983,15850,6947,2535,25.205277427,15816,1.4378967326,6513,1305
2023-2024,10,06,Montréal,CIUSSS DU NORD-DE-L'ÎLE-DE-MONTRÉAL,HÔPITAL EN SANTÉ MENTALE ALBERT-PRÉVOST,51848752,2562,82,2556,23.305268345,2521,0.3601992155,1100,28,1094,4.2182128788,1059,0.4735570769,1462,873,408,37.66625399,1462,0.2780884253,54,1462
2023-2024,10,06,Montréal,CIUSSS DU NORD-DE-L'ÎLE-DE-MONTRÉAL,HÔPITAL FLEURY,51228492,23134,3916,732,10.105231598,16996,4.0713288748,16588,1420,330,6.2127608981,10469,5.208600657,6546,2233,228,19.96901161,6527,2.2471986024,2496,402
2023-2024,10,06,Montréal,CIUSSS DU NORD-DE-L'ÎLE-DE-MONTRÉAL,HÔPITAL JEAN-TALON,51228500,32433,4205,2592,7.9705103598,23917,3.1740659247,24058,1429,948,5.1177686332,15580,4.0287915419,8375,1965,87,16.165287728,8337,1.5767737196,2776,1644
2023-2024,10,06,Montréal,INSTITUT DE CARDIOLOGIE DE MONTRÉAL,INSTITUT DE CARDIOLOGIE DE MONTRÉAL,51248201,15100,4180,388,8.66792695,14616,1.4991361065,9521,1881,325,3.9437373525,9041,1.7642443375,5579,1251,84,16.730126118,5575,1.0692090184,2299,63
2023-2024,10,07,Outaouais,CISSS DE L'OUTAOUAIS,CENTRE MULTISERVICES DE SANTÉ ET DE SERVICES SOCIAUX DE MANSFIELD-ET-PONTEFRACT,51245058,7306,793,200,4.0481124722,6850,1.643314558,6954,741,184,3.9414212044,6498,1.6486825433,352,3,0,6.1558712121,352,1.5442203283,52,16
2023-2024,10,07,Outaouais,CISSS DE L'OUTAOUAIS,CLSC ET CENTRE D'HÉBERGEMENT DE LA PETITE-NATION,51219491,8123,1051,312,2.9841288796,6758,1.4223409293,7448,842,285,2.8179850668,6084,1.5084704873,675,5,0,4.8173720165,674,0.6448747115,209,27
2023-2024,10,07,Outaouais,CISSS DE L'OUTAOUAIS,HÔPITAL DE GATINEAU,51221703,29638,3857,3337,12.926454017,18517,5.2084234307,18963,1376,912,6.6640258369,8245,5.9233580958,10675,3630,1470,24.050990372,10272,4.6345686494,2481,2425
2023-2024,10,07,Outaouais,CISSS DE L'OUTAOUAIS,HÔPITAL DE HULL,51221711,26188,5025,806,14.08730028,17382,4.4460514549,16983,1662,483,7.0532133604,8418,5.2004539215,9205,3358,1641,27.06501871,8964,3.7375998748,3363,323
2023-2024,10,07,Outaouais,CISSS DE L'OUTAOUAIS,HÔPITAL DE MANIWAKI,51221893,10092,1366,565,7.136434965,8707,2.4399955017,7148,657,298,3.576969704,5848,2.5738168795,2944,536,242,15.778777929,2859,2.1662678287,709,267
2023-2024,10,07,Outaouais,CISSS DE L'OUTAOUAIS,HÔPITAL ET CHSLD DE PAPINEAU,51228823,17034,2184,789,9.6225054303,12803,3.7057057374,12524,921,291,4.3832708533,8359,3.9737536056,4510,1497,655,24.171546194,4444,3.2015175893,1263,498
2023-2024,10,07,Outaouais,CISSS DE L'OUTAOUAIS,HÔPITAL ET CHSLD DU PONTIAC,51219459,8701,1042,233,5.7087649568,7970,2.1742955528,6674,655,138,4.3525829088,5949,2.209267524,2027,216,42,10.174062928,2021,2.0713523283,387,95
2023-2024,10,07,Outaouais,CISSS DE L'OUTAOUAIS,HÔPITAL ET CHSLD MÉMORIAL DE WAKEFIELD / WAKEFIELD MEMORIAL HOSPITAL,51228799,12302,1030,309,5.6070782754,10164,2.7477145371,10821,677,220,4.0898298062,8695,2.8716119417,1481,303,101,16.692929515,1469,2.0143667272,353,89
2023-2024,10,08,Abitibi-Témiscamingue,CISSS DE L'ABITIBI-TÉMISCAMINGUE,CENTRE MULTISERVICES DE SANTÉ ET DE SERVICES SOCIAUX DE LA SARRE,51247559,13824,1784,671,6.1644780615,12490,2.4025522196,11317,1038,511,4.5550998498,10015,2.5280738892,2507,305,137,13.429469375,2475,1.8946332211,746,160
2023-2024,10,08,Abitibi-Témiscamingue,CISSS DE L'ABITIBI-TÉMISCAMINGUE,CENTRE MULTISERVICES DE SANTÉ ET DE SERVICES SOCIAUX DE TÉMISCAMING-KIPAWA,51247476,4041,335,199,2.7957305672,3826,0.9944471307,3761,271,160,2.230285976,3549,1.0178248959,280,25,0,10.390863095,277,0.6949247894,64,39
2023-2024,10,08,Abitibi-Témiscamingue,CISSS DE L'ABITIBI-TÉMISCAMINGUE,CENTRE MULTISERVICES DE SANTÉ ET DE SERVICES SOCIAUX DE VILLE-MARIE,51247542,8596,1252,422,4.8556798705,7532,2.6700051632,7348,844,304,4.0759897629,6298,2.7377250715,1248,33,2,9.4463552796,1234,2.3243811903,408,118
2023-2024,10,08,Abitibi-Témiscamingue,CISSS DE L'ABITIBI-TÉMISCAMINGUE,HÔPITAL D'AMOS,51228906,17842,1777,780,4.5484876976,15810,1.8230588235,13510,731,579,3.0935269553,11535,2.0395898714,4332,256,17,9.0860037704,4275,1.2388048733,1046,201
2023-2024,10,08,Abitibi-Témiscamingue,CISSS DE L'ABITIBI-TÉMISCAMINGUE,HÔPITAL DE ROUYN-NORANDA,51228922,20097,2617,1052,6.9138573751,15651,3.8258649252,15974,1293,666,5.8712433225,11587,4.3676389968,4123,339,9,10.953323025,4064,2.2811955927,1324,386
2023-2024,10,08,Abitibi-Témiscamingue,CISSS DE L'ABITIBI-TÉMISCAMINGUE,HÔPITAL DE VAL-D'OR,51225589,21046,2319,1340,8.2031251254,17084,3.7358557877,17086,1304,948,6.3858891295,13136,4.2552151424,3960,894,169,16.04385599,3948,2.0078151385,1015,392
2023-2024,10,09,Côte-Nord,CISSS DE LA CÔTE-NORD,CENTRE MULTISERVICES DE SANTÉ ET DE SERVICES SOCIAUX DE FERMONT,51245108,4414,16,279,5.899328903,3574,2.1716115619,4183,13,265,5.9041458815,3343,2.2352298335,231,2,0,5.8121019721,231,1.2509367484,3,14
2023-2024,10,09,Côte-Nord,CISSS DE LA CÔTE-NORD,CENTRE MULTISERVICES DE SANTÉ ET DE SERVICES SOCIAUX DE FORESTVILLE,51218741,8487,1111,402,3.1386940484,7039,1.7248687866,7525,855,336,2.6182181986,6173,1.8214349227,962,43,7,7.20998383,866,1.0365284193,256,66
2023-2024,10,09,Côte-Nord,CISSS DE LA CÔTE-NORD,CENTRE MULTISERVICES DE SANTÉ ET DE SERVICES SOCIAUX DE LA BASSE-CÔTE-NORD,51245140,2339,338,76,2.7958934255,2271,0.9290109594,1895,238,63,2.511377895,1832,0.9448642952,444,1,0,4.0102108358,439,0.8628530752,100,13
2023-2024,10,09,Côte-Nord,CISSS DE LA CÔTE-NORD,CENTRE MULTISERVICES DE SANTÉ ET DE SERVICES SOCIAUX DE LA MINGANIE,51245116,10702,1135,275,2.9628890239,5413,2.2792730977,7613,773,120,1.5368128713,2418,2.4271393944,3089,105,1,6.4775273371,2995,2.1598938972,362,155
2023-2024,10,09,Côte-Nord,CISSS DE LA CÔTE-NORD,CENTRE MULTISERVICES DE SANTÉ ET DE SERVICES SOCIAUX DE PORT-CARTIER,51245132,10590,980,525,5.0753489665,9107,2.6358250979,9625,742,476,4.077901443,8151,2.7759041835,965,165,45,15.023983592,956,1.4414897141,238,49
2023-2024,10,09,Côte-Nord,CISSS DE LA CÔTE-NORD,CENTRE MULTISERVICES DE SANTÉ ET DE SERVICES SOCIAUX DES ESCOUMINS,51218733,7080,1000,287,3.7041911488,6334,1.520768998,6311,721,246,2.9310321485,5579,1.5655019816,769,57,13,10.049323075,755,1.190218911,279,41
2023-2024,10,09,Côte-Nord,CISSS DE LA CÔTE-NORD,CLSC ET HÔPITAL LE ROYER,51228765,17108,2561,1105,9.170695305,14996,3.3695825368,12614,1152,599,5.2340791977,10511,3.8765675906,4494,1257,514,20.220200329,4485,2.1814175647,1409,506
2023-2024,10,09,Côte-Nord,CISSS DE LA CÔTE-NORD,HÔPITAL ET CLSC DE SEPT-ÎLES,51232023,16164,1811,1129,9.5191494301,12679,3.8711778444,10884,678,483,5.1147728062,7545,4.264637361,5280,1242,446,18.598171244,5134,3.2929440982,1133,646
2023-2024,10,11,Gaspésie-Îles-de-la-Madeleine,CISSS DE LA GASPÉSIE,CENTRE MULTISERVICES DE SANTÉ ET DE SERVICES SOCIAUX DE GRANDE-VALLÉE,51247732,5028,922,143,2.06795556,3887,1.079537704,4654,781,124,1.6979870959,3535,1.0995031432,374,20,3,6.6717877302,352,0.8790325126,141,19
2023-2024,10,11,Gaspésie-Îles-de-la-Madeleine,CISSS DE LA GASPÉSIE,CLSC ET CENTRE DE SERVICES AMBULATOIRES DE MURDOCHVILLE,51221307,1650,218,93,3.014593266,1618,1.4827297075,1619,210,90,2.9804239585,1588,1.5039062063,31,0,0,4.7991129032,30,0.361787037,8,3
2023-2024,10,11,Gaspésie-Îles-de-la-Madeleine,CISSS DE LA GASPÉSIE,CLSC ET CENTRE DE SERVICES AMBULATOIRES DE PASPÉBIAC,51220978,9917,1785,384,4.4334776142,9246,1.9030022592,7579,1096,305,3.379772654,6981,1.9945141575,2338,128,20,7.8492303488,2265,1.6209516802,689,79
2023-2024,10,11,Gaspésie-Îles-de-la-Madeleine,CISSS DE LA GASPÉSIE,HÔPITAL DE CHANDLER,51227775,11885,2085,499,6.0738944748,10608,1.9427515135,10014,1363,376,3.7179149746,8745,2.0938900324,1871,528,120,18.683610517,1863,1.2333009781,722,123
2023-2024,10,11,Gaspésie-Îles-de-la-Madeleine,CISSS DE LA GASPÉSIE,HÔPITAL DE GASPÉ,51220903,10572,1771,386,5.7671923477,9069,1.7080225984,8463,1032,234,3.6950211378,6999,1.941674009,2109,335,68,14.082405695,2070,0.9180099302,739,152
2023-2024,10,11,Gaspésie-Îles-de-la-Madeleine,CISSS DE LA GASPÉSIE,HÔPITAL ET CLSC DE SAINTE-ANNE-DES-MONTS,51247799,10269,1740,447,5.2185270393,9174,2.0204993884,8064,945,307,3.1716562982,6991,2.1531463866,2205,328,69,12.70422575,2183,1.5957008704,795,140
2023-2024,10,11,Gaspésie-Îles-de-la-Madeleine,CISSS DE LA GASPÉSIE,HÔPITAL ET GROUPE DE MÉDECINE DE FAMILLE UNIVERSITAIRE DE MARIA,51227908,13031,2389,650,7.957268991,11963,2.1299362154,9586,1128,316,4.0212558534,8529,2.3774717956,3445,998,308,18.909554024,3434,1.5151339546,1261,334
2023-2024,10,11,Gaspésie-Îles-de-la-Madeleine,CISSS DES ÎLES,HÔPITAL DE L'ARCHIPEL,51227783,13045,1833,389,3.9923437247,11610,1.4929402574,10626,1185,229,2.8607443221,9214,1.5729477184,2419,131,0,8.9631478802,2396,1.1852654888,648,160
2023-2024,10,12,Chaudière-Appalaches,CISSS DE CHAUDIÈRE-APPALACHES,CHSLD ET HÔPITAL PAUL-GILBERT,51245199,34075,2561,447,2.6507337572,26131,2.1231697133,33395,2486,438,2.6331919283,25451,2.1606096464,680,0,0,3.5122181373,680,0.721870098,75,9
2023-2024,10,12,Chaudière-Appalaches,CISSS DE CHAUDIÈRE-APPALACHES,HÔPITAL DE MONTMAGNY,51245223,25650,4062,745,4.2901603314,23610,1.4713971128,20143,2155,416,2.5971945865,18103,1.7095321217,5507,426,36,10.482535309,5507,0.6885828642,1907,329
2023-2024,10,12,Chaudière-Appalaches,CISSS DE CHAUDIÈRE-APPALACHES,HÔPITAL DE SAINT-GEORGES,51228971,34231,6245,1740,6.4977935043,27786,2.5606423499,24649,2550,858,4.0675028511,18242,3.2040622069,9582,1271,76,12.749539936,9544,1.3308367095,3695,882
2023-2024,10,12,Chaudière-Appalaches,CISSS DE CHAUDIÈRE-APPALACHES,HÔPITAL DE THETFORD,51245231,29856,4873,886,5.6746334908,27580,1.6396521634,23625,2628,476,3.9680138507,21355,1.8581185255,6231,781,34,12.145326637,6225,0.8901984828,2245,410
2023-2024,10,12,Chaudière-Appalaches,CISSS DE CHAUDIÈRE-APPALACHES,HÔTEL-DIEU DE LÉVIS,51227569,59072,11416,3885,8.210450834,53257,1.6026943041,40820,4338,1892,3.6974057175,35013,2.061856136,18252,4787,1267,18.303728374,18244,0.721493185,7078,1993
2023-2024,10,13,Laval,CISSS DE LAVAL,HÔPITAL DE LA CITÉ-DE-LA-SANTÉ,51228757,69561,13493,4348,9.7876321342,54277,3.0068660093,44223,4116,1040,5.4492635619,28999,3.8419205739,25338,5831,653,17.359487583,25278,2.048888823,9377,3308
2023-2024,10,14,Lanaudière,CISSS DE LANAUDIÈRE,HÔPITAL DE LANAUDIÈRE ET CENTRE D'HÉBERGEMENT PARPHILIA-FERLAND,51244945,55027,9659,3747,10.179637774,44163,2.7337330143,35808,2996,2606,5.7944626123,25063,3.6669051878,19219,5402,1398,18.34990429,19100,1.5092254654,6663,1141
2023-2024,10,14,Lanaudière,CISSS DE LANAUDIÈRE,HÔPITAL PIERRE-LE GARDEUR,51228062,57391,10575,3262,11.089831633,37159,5.5052925342,38339,3684,1100,6.6734352603,18209,6.856135458,19052,6542,681,19.977099138,18950,4.2072714893,6891,2162
2023-2024,10,15,Laurentides,CISSS DES LAURENTIDES,CENTRE MULTISERVICES DE SANTÉ ET DE SERVICES SOCIAUX D'ARGENTEUIL,51245306,15041,1967,458,9.0585135629,12205,3.5212929127,12458,1112,290,5.7636896639,9636,3.9924554045,2583,1009,400,24.949692864,2569,1.7540209117,855,168
2023-2024,10,15,Laurentides,CISSS DES LAURENTIDES,CENTRE MULTISERVICES DE SANTÉ ET DE SERVICES SOCIAUX DE RIVIÈRE-ROUGE,51217628,10851,1285,638,6.4000103933,9548,2.8612482253,8514,735,341,4.1693372354,7262,3.0263063053,2337,428,103,14.526647649,2286,2.3369036162,550,297
2023-2024,10,15,Laurentides,CISSS DES LAURENTIDES,CENTRE MULTISERVICES DE SANTÉ ET DE SERVICES SOCIAUX DE SAINTE-AGATHE,51246874,23945,4517,1426,11.506321837,19214,3.8856707638,15519,1711,421,6.2963792949,10877,4.9009631434,8426,2810,697,21.101989807,8337,2.5610533699,2806,1005
2023-2024,10,15,Laurentides,CISSS DES LAURENTIDES,HÔPITAL DE MONT-LAURIER,51217610,13650,1953,773,10.21949359,11073,3.7779994381,10123,969,391,6.6758301777,7595,4.188857728,3527,999,314,20.390319992,3478,2.8807973931,984,382
2023-2024,10,15,Laurentides,CISSS DES LAURENTIDES,HÔPITAL DE SAINT-EUSTACHE,51228864,38496,8086,2377,12.860006032,27176,4.0143997768,23208,2238,600,7.5370068391,11984,5.9508992546,15288,5310,1178,20.940602924,15192,2.4868188301,5848,1777
2023-2024,10,15,Laurentides,CISSS DES LAURENTIDES,HÔPITAL DE SAINT-JÉRÔME,51228880,44341,8154,4253,14.41491187,31670,4.5817160474,25419,2566,1087,6.917930037,12897,6.400590792,18922,6740,2707,24.486034437,18773,3.3321540392,5588,3166
2023-2024,10,16,Montérégie,CISSS DE LA MONTÉRÉGIE-CENTRE,HÔPITAL CHARLES-LE MOYNE,51233799,58344,10833,4449,9.9825327607,32070,5.4212048557,40618,4357,1765,5.9656689426,14363,6.3687057989,17726,5683,453,19.186920359,17707,4.6526412342,6476,2684
2023-2024,10,16,Montérégie,CISSS DE LA MONTÉRÉGIE-CENTRE,HÔPITAL DU HAUT-RICHELIEU,51229045,46829,7914,2699,10.865740543,35990,3.5610622549,31888,2661,833,5.8888094877,21244,4.421070263,14941,4602,2117,21.487812526,14746,2.3220815061,5253,1866
2023-2024,10,16,Montérégie,CISSS DE LA MONTÉRÉGIE-EST,HÔPITAL HONORÉ-MERCIER,51229193,35569,6988,1839,9.8030983987,27572,4.4013647098,20108,2449,770,6.3304384104,12364,5.8008483411,15461,3036,527,14.319510471,15208,3.2635940879,4539,1069
2023-2024,10,16,Montérégie,CISSS DE LA MONTÉRÉGIE-EST,HÔPITAL PIERRE-BOUCHER,51229011,44682,9642,2649,13.34763113,32180,5.095484471,21826,3088,808,6.8167198652,9573,6.8239488666,22856,6124,2188,19.584228491,22607,4.363561188,6554,1841
2023-2024,10,16,Montérégie,CISSS DE LA MONTÉRÉGIE-EST,HÔTEL-DIEU DE SOREL,51229102,28782,4587,1430,8.030621569,24656,2.4001228009,19851,1854,484,4.0362494333,15793,2.684972333,8931,2374,449,16.908942168,8863,1.892548767,2733,946
2023-2024,10,16,Montérégie,CISSS DE LA MONTÉRÉGIE-OUEST,HÔPITAL ANNA-LABERGE,51229151,28742,6329,1823,18.521697825,22159,2.5596199939,17513,1851,416,10.735213207,10931,4.0909442056,11229,5457,2454,30.665673702,11228,1.0688019534,4478,1407
2023-2024,10,16,Montérégie,CISSS DE LA MONTÉRÉGIE-OUEST,HÔPITAL BARRIE MEMORIAL / BARRIE MEMORIAL HOSPITAL,51228005,16837,1846,295,6.4082399543,14056,3.3330669386,14278,1125,225,4.4447566964,11517,3.209065946,2559,625,124,17.363540445,2539,3.8955401295,721,70
2023-2024,10,16,Montérégie,CISSS DE LA MONTÉRÉGIE-OUEST,HÔPITAL DU SUROÎT,51229136,30986,6234,2365,12.92061561,24625,2.4809097124,20418,2023,1367,4.8637724883,14091,3.3180464481,10568,4040,2095,28.486912246,10534,1.3610982691,4211,998
2024-2025,10,01,Bas-Saint-Laurent,CISSS DU BAS-SAINT-LAURENT,CENTRE HOSPITALIER RÉGIONAL DU GRAND-PORTAGE,51218352,17703,3534,862,5.07925201,14649,2.28586464,12910,1503,476,3.36246084,9890,2.5747479778,4793,143,0,9.7034485477,4759,1.6855166235,2031,386
2024-2025,10,01,Bas-Saint-Laurent,CISSS DU BAS-SAINT-LAURENT,CENTRE MULTISERVICES DE SANTÉ ET DE SERVICES SOCIAUX DE TROIS-PISTOLES,51236156,10021,1430,269,3.2448550544,9127,1.5943030447,8678,929,203,2.6413143389,7804,1.6949099465,1343,11,1,7.1447257384,1323,1.0008515999,501,66
2024-2025,10,01,Bas-Saint-Laurent,CISSS DU BAS-SAINT-LAURENT,CLSC DE POHÉNÉGAMOOK,51219418,10500,1216,353,1.8336595238,9805,1.0298152587,9935,1050,335,1.5508945926,9243,1.0377030065,565,15,0,6.8058180924,562,0.9000884737,166,18
2024-2025,10,01,Bas-Saint-Laurent,CISSS DU BAS-SAINT-LAURENT,HÔPITAL D'AMQUI,51226892,12421,1927,401,4.7602219807,10810,1.8346070511,8865,915,252,3.5808173216,7377,2.1737779585,3556,194,25,7.700441976,3433,1.1057798492,1012,149
2024-2025,10,01,Bas-Saint-Laurent,CISSS DU BAS-SAINT-LAURENT,HÔPITAL DE MATANE,51218980,14233,2481,566,5.2505227679,12752,2.5384740084,10543,1212,322,4.212981362,9151,2.845735378,3690,246,23,8.2149669527,3601,1.7576495726,1269,244
2024-2025,10,01,Bas-Saint-Laurent,CISSS DU BAS-SAINT-LAURENT,HÔPITAL DE NOTRE-DAME-DU-LAC,51221877,11466,1965,309,3.6262051331,10278,1.5913119716,9097,1095,158,2.5340768324,7921,1.7947077039,2369,44,1,7.8199962478,2357,0.9077745958,870,151
2024-2025,10,01,Bas-Saint-Laurent,CISSS DU BAS-SAINT-LAURENT,HÔPITAL NOTRE-DAME-DE-FATIMA,51221141,14490,2531,420,4.5061649988,13144,2.1238549063,11497,1359,216,3.3969844549,10191,2.308491643,2993,91,2,8.7668561829,2953,1.4866612108,1172,204
2024-2025,10,01,Bas-Saint-Laurent,CISSS DU BAS-SAINT-LAURENT,HÔPITAL RÉGIONAL DE RIMOUSKI,51227882,24968,4654,1358,6.7354209388,19740,2.7062696302,17770,2053,786,4.6083021947,12603,3.2579034974,7198,879,116,11.986726869,7137,1.7321570299,2601,572
2024-2025,10,02,Saguenay-Lac-Saint-Jean,CIUSSS DU SAGUENAY - LAC-SAINT-JEAN,HÔPITAL D'ALMA,51219400,29824,4629,1155,4.9297515424,23791,3.0005240194,23268,2578,564,3.9445779611,17386,3.2690045311,6556,108,1,8.4262461867,6405,2.2717492844,2051,591
2024-2025,10,02,Saguenay-Lac-Saint-Jean,CIUSSS DU SAGUENAY - LAC-SAINT-JEAN,HÔPITAL DE CHICOUTIMI,51218394,42659,7136,2588,8.0052751992,37106,2.9248439156,24079,2151,723,4.5138863509,18719,3.9164546866,18580,2531,170,12.529987367,18387,1.9153283872,4985,1865
2024-2025,10,02,Saguenay-Lac-Saint-Jean,CIUSSS DU SAGUENAY - LAC-SAINT-JEAN,HÔPITAL DE DOLBEAU-MISTASSINI,51219384,18023,2939,587,4.925375662,16082,2.3417287962,15237,1944,360,3.6000163345,13319,2.5268196645,2786,326,77,12.173939938,2763,1.4495010456,995,227
2024-2025,10,02,Saguenay-Lac-Saint-Jean,CIUSSS DU SAGUENAY - LAC-SAINT-JEAN,HÔPITAL DE LA BAIE,51221364,15514,2127,477,5.6057391174,13926,2.8360236049,11783,937,274,4.2583936132,10236,3.1337054134,3731,114,2,9.8608375026,3690,2.0102591087,1190,203
2024-2025,10,02,Saguenay-Lac-Saint-Jean,CIUSSS DU SAGUENAY - LAC-SAINT-JEAN,HÔPITAL ET CENTRE D'HÉBERGEMENT DE ROBERVAL,51228203,20879,2917,1135,5.6297378546,18586,2.6000624126,14674,1268,386,3.8523406857,12523,2.849325663,6205,403,16,9.8330458412,6063,2.0852143695,1649,749
2024-2025,10,02,Saguenay-Lac-Saint-Jean,CIUSSS DU SAGUENAY - LAC-SAINT-JEAN,HÔPITAL ET CENTRE DE RÉADAPTATION DE JONQUIÈRE,51224541,21798,4157,1152,7.4531307663,17166,3.8276927583,13692,1429,449,4.7397362004,9332,4.1895377911,8106,731,17,12.036377546,7834,3.3966565257,2728,703
2024-2025,10,03,Capitale-Nationale,CHU DE QUÉBEC - UNIVERSITÉ LAVAL,CENTRE HOSPITALIER DE L'UNIVERSITÉ LAVAL,51217594,60444,5559,5725,8.1820419176,48518,2.4810921834,34311,1135,1976,5.1361588363,22560,3.6466230792,26133,2970,514,12.181096538,25958,1.4681336732,4424,3749
2024-2025,10,03,Capitale-Nationale,CHU DE QUÉBEC - UNIVERSITÉ LAVAL,HÔPITAL DE L'ENFANT-JÉSUS,51233914,51581,9097,6259,9.8494374005,46134,1.8084243123,28632,2870,1644,4.2482833892,23351,2.3219730656,22949,5395,947,16.837639137,22783,1.282072342,6227,4615
2024-2025,10,03,Capitale-Nationale,CHU DE QUÉBEC - UNIVERSITÉ LAVAL,HÔPITAL DU SAINT-SACREMENT,51217529,29465,6845,870,7.6262799555,24194,2.1433118174,20782,2752,313,3.9109866043,15534,2.5813876014,8683,2187,280,16.518509188,8660,1.3575070567,4093,557
2024-2025,10,03,Capitale-Nationale,CHU DE QUÉBEC - UNIVERSITÉ LAVAL,HÔPITAL SAINT-FRANÇOIS D'ASSISE,51217602,32862,8605,1093,10.92774012,26944,2.4706312681,18699,2341,533,5.1159398007,12825,3.5320633528,14163,4329,478,18.60089229,14119,1.5064789566,6264,560
2024-2025,10,03,Capitale-Nationale,CHU DE QUÉBEC - UNIVERSITÉ LAVAL,L'HÔTEL-DIEU DE QUÉBEC,51217586,18502,4078,843,7.1372454479,16398,1.8696746554,10062,946,360,3.5239978798,8073,2.1831697221,8440,673,14,11.444887276,8325,1.5656691692,3132,483
2024-2025,10,03,Capitale-Nationale,CIUSSS DE LA CAPITALE-NATIONALE,CENTRE MULTISERVICES DE SANTÉ ET DE SERVICES SOCIAUX CHAUVEAU,51225001,34939,2478,521,3.0070030784,24428,1.8033878587,32103,2151,467,2.8815672298,21633,1.9093216896,2836,0,0,4.426913885,2795,0.9834713775,327,54
2024-2025,10,03,Capitale-Nationale,CIUSSS DE LA CAPITALE-NATIONALE,CENTRE MULTISERVICES DE SANTÉ ET DE SERVICES SOCIAUX DE BAIE-SAINT-PAUL,51244804,11119,1901,337,5.5056628794,8596,2.4590899837,8987,1128,168,3.5266238888,6490,2.7427128488,2132,308,52,13.847887742,2106,1.5850575077,773,169
2024-2025,10,03,Capitale-Nationale,CIUSSS DE LA CAPITALE-NATIONALE,CENTRE MULTISERVICES DE SANTÉ ET DE SERVICES SOCIAUX DE SAINT-MARC-DES-CARRIÈRES,51247344,15226,1959,293,2.9229283426,12570,1.5552404977,12821,1172,192,2.3099791358,10201,1.7553165267,2405,52,6,6.1905465465,2369,0.6937058534,787,101
2024-2025,10,03,Capitale-Nationale,CIUSSS DE LA CAPITALE-NATIONALE,CENTRE MULTISERVICES DE SANTÉ ET DE SERVICES SOCIAUX DE SAINT-RAYMOND,51247302,16287,2398,341,4.5702800291,12950,2.1831301158,12958,1256,203,3.5338229494,9685,2.5203961739,3329,161,25,8.604647959,3265,1.1826946571,1142,138
2024-2025,10,03,Capitale-Nationale,CIUSSS DE LA CAPITALE-NATIONALE,CENTRE MULTISERVICES DE SANTÉ ET DE SERVICES SOCIAUX DE SAINTE-ANNE-DE-BEAUPRÉ,51225357,13428,1612,205,4.342290591,10271,2.2505812752,11272,957,132,3.4516103077,8163,2.4878377367,2156,99,14,8.9989455782,2108,1.3318315149,655,73
2024-2025,10,03,Capitale-Nationale,CIUSSS DE LA CAPITALE-NATIONALE,HÔPITAL ET CLSC DE LA MALBAIE,51228690,12247,2122,332,4.9719456692,10098,1.9032689091,10158,1402,185,3.3609095732,8016,2.1702675205,2089,264,43,12.805791846,2082,0.8752857829,720,147
2024-2025,10,03,Capitale-Nationale,INSTITUT UNIVERSITAIRE DE CARDIOLOGIE ET DE PNEUMOLOGIE DE QUÉBEC - UNIVERSITÉ LAVAL,INSTITUT UNIVERSITAIRE DE CARDIOLOGIE ET DE PNEUMOLOGIE DE QUÉBEC,51232130,24153,8137,483,7.9309131716,22508,2.1003043362,12650,2877,252,4.0856190162,11042,2.6773971603,11503,1189,0,12.159633598,11466,1.5445517666,5260,231
2024-2025,10,04,Mauricie et Centre-du-Québec,CIUSSS DE LA MAURICIE-ET-DU-CENTRE-DU-QUÉBEC,CENTRE MULTISERVICES DE SANTÉ ET DE SERVICES SOCIAUX AVELLIN-DALCOURT,51233583,18385,2623,407,4.8082382981,14683,2.9175504363,15734,1540,212,4.0636949529,12064,3.2431757479,2651,113,17,9.227191521,2619,1.4176100929,1083,195
2024-2025,10,04,Mauricie et Centre-du-Québec,CIUSSS DE LA MAURICIE-ET-DU-CENTRE-DU-QUÉBEC,CENTRE MULTISERVICES DE SANTÉ ET DE SERVICES SOCIAUX CHRIST-ROI,51246338,18736,2162,509,5.2733335705,14949,3.4849251343,15091,1016,290,4.3813433687,11458,3.8036813192,3645,195,26,8.9663443073,3491,2.4387182119,1146,219
2024-2025,10,04,Mauricie et Centre-du-Québec,CIUSSS DE LA MAURICIE-ET-DU-CENTRE-DU-QUÉBEC,CENTRE MULTISERVICES DE SANTÉ ET DE SERVICES SOCIAUX DE FORTIERVILLE,51219160,10356,1129,167,2.7741651378,7790,2.1770264584,9536,984,153,2.6745684482,6976,2.2789787207,820,0,0,3.9324017615,814,1.3032930658,145,14
2024-2025,10,04,Mauricie et Centre-du-Québec,CIUSSS DE LA MAURICIE-ET-DU-CENTRE-DU-QUÉBEC,CENTRE MULTISERVICES DE SANTÉ ET DE SERVICES SOCIAUX DU HAUT-SAINT-MAURICE,51219731,9964,1440,538,6.1019681966,8617,2.7774691179,7443,803,268,4.1767919522,6144,3.0036756727,2521,202,6,11.785858235,2473,2.2154743451,637,270
2024-2025,10,04,Mauricie et Centre-du-Québec,CIUSSS DE LA MAURICIE-ET-DU-CENTRE-DU-QUÉBEC,HÔPITAL DU CENTRE-DE-LA-MAURICIE,51220051,28107,5572,1940,7.6249734645,22831,3.0105878825,17317,1685,420,4.9852304736,12098,4.3345637938,10790,1134,87,11.86152855,10733,1.5182315445,3887,1520
2024-2025,10,04,Mauricie et Centre-du-Québec,CIUSSS DE LA MAURICIE-ET-DU-CENTRE-DU-QUÉBEC,HÔPITAL SAINTE-CROIX,51228781,34317,5434,2048,8.2973392682,25196,3.8493865869,19341,1537,541,6.2244795167,10764,5.3377384492,14976,1246,10,10.974367877,14432,2.7393104059,3897,1507
2024-2025,10,04,Mauricie et Centre-du-Québec,CIUSSS DE LA MAURICIE-ET-DU-CENTRE-DU-QUÉBEC,HÔTEL-DIEU D'ARTHABASKA,51228039,30948,5951,1667,6.1893999612,25561,2.5756022087,18071,2007,329,4.5312921562,12949,3.4011391914,12877,484,3,8.5163135392,12612,1.728006396,3944,1338
2024-2025,10,04,Mauricie et Centre-du-Québec,CIUSSS DE LA MAURICIE-ET-DU-CENTRE-DU-QUÉBEC,PAVILLON SAINTE-MARIE,51220168,48552,11373,2771,10.087902489,36989,3.6138972622,26722,2857,818,5.700631762,15364,5.2561098817,21830,4510,339,15.458339886,21625,2.4471479127,8516,1953
2024-2025,10,05,Estrie,CIUSSS DE L'ESTRIE - CENTRE HOSPITALIER UNIVERSITAIRE DE SHERBROOKE,CENTRE DE SANTÉ ET DE SERVICES SOCIAUX DU GRANIT,51223832,12643,2075,332,5.2445469386,10845,3.1347570565,10214,1248,184,4.3190454822,8441,3.3895794666,2429,97,1,9.1363015187,2404,2.2400166389,827,148
2024-2025,10,05,Estrie,CIUSSS DE L'ESTRIE - CENTRE HOSPITALIER UNIVERSITAIRE DE SHERBROOKE,CENTRE MULTISERVICES DE SANTÉ ET DE SERVICES SOCIAUX DE LA MRC DE COATICOOK,51247617,17528,1351,489,2.9989510434,14019,2.2858445086,14211,896,384,2.8411274717,10796,2.4469489729,3317,0,0,3.6751134727,3223,1.7461970386,455,105
2024-2025,10,05,Estrie,CIUSSS DE L'ESTRIE - CENTRE HOSPITALIER UNIVERSITAIRE DE SHERBROOKE,CENTRE MULTISERVICES DE SANTÉ ET DE SERVICES SOCIAUX DE MEMPHRÉMAGOG,51219046,19552,3988,650,7.3134173543,15167,4.1265674564,14262,1861,301,5.354768499,10033,4.7392489507,5290,755,136,12.593993909,5134,2.9292489071,2127,349
2024-2025,10,05,Estrie,CIUSSS DE L'ESTRIE - CENTRE HOSPITALIER UNIVERSITAIRE DE SHERBROOKE,CENTRE MULTISERVICES DE SANTÉ ET DE SERVICES SOCIAUX DES SOURCES,51247583,15119,1899,479,5.121720554,12609,3.5561434293,13129,1269,332,4.5837645247,10656,3.823828516,1990,81,4,8.6708786991,1953,2.0955943847,630,147
2024-2025,10,05,Estrie,CIUSSS DE L'ESTRIE - CENTRE HOSPITALIER UNIVERSITAIRE DE SHERBROOKE,CHUS - HÔPITAL FLEURIMONT,51216687,36939,5442,858,8.9503086169,31245,3.091177255,19209,1080,284,6.7475245978,13521,5.4344168331,17730,1857,52,11.336844332,17724,1.3036043406,4362,574
2024-2025,10,05,Estrie,CIUSSS DE L'ESTRIE - CENTRE HOSPITALIER UNIVERSITAIRE DE SHERBROOKE,CHUS - HÔTEL-DIEU DE SHERBROOKE,51216695,37031,8153,4232,11.541602531,31231,3.5615520903,18346,2065,1007,7.104337912,12583,5.6263344724,18685,3204,757,15.898362323,18648,2.1683111683,6088,3225
2024-2025,10,05,Estrie,CIUSSS DE L'ESTRIE - CENTRE HOSPITALIER UNIVERSITAIRE DE SHERBROOKE,HÔPITAL BROME-MISSISQUOI-PERKINS,51229185,23652,3890,794,9.3587568352,19297,4.2613348793,16187,1206,301,5.9429558528,11915,4.9532996456,7465,1958,160,16.765531183,7382,3.1444613775,2684,493
2024-2025,10,05,Estrie,CIUSSS DE L'ESTRIE - CENTRE HOSPITALIER UNIVERSITAIRE DE SHERBROOKE,HÔPITAL DE GRANBY,51228120,30331,5099,1776,12.045283456,22645,5.3093507029,21165,2001,695,8.1054233535,13522,6.8379403318,9166,3462,510,21.142723895,9123,3.0436936863,3098,1081
2024-2025,10,06,Montréal,CENTRE HOSPITALIER DE L'UNIVERSITÉ DE MONTRÉAL,CENTRE HOSPITALIER DE L'UNIVERSITÉ DE MONTRÉAL,51236297,61999,9248,5296,12.052487782,44445,3.2263127773,37250,2628,1892,7.6363475391,19875,5.3032500908,24749,7347,767,18.699270442,24570,1.5462505427,6620,3404
2024-2025,10,06,Montréal,CENTRE HOSPITALIER UNIVERSITAIRE SAINTE-JUSTINE,CHU SAINTE-JUSTINE,51222800,64544,1,1550,5.0811233121,55070,1.8059714202,41282,0,575,4.2870562567,32376,2.3470254458,23262,363,7,6.4903175422,22694,1.0340861143,1,975
2024-2025,10,06,Montréal,CENTRE UNIVERSITAIRE DE SANTÉ MCGILL,HÔPITAL DE LACHINE,51228310,15735,2509,492,10.984024997,13050,3.3847120051,12049,1133,218,5.3179408619,9399,3.6446257581,3686,1340,725,29.505633177,3651,2.7155996074,1376,274
2024-2025,10,06,Montréal,CENTRE UNIVERSITAIRE DE SANTÉ MCGILL,HÔPITAL GÉNÉRAL DE MONTRÉAL,51248219,27357,3880,3649,16.717212424,23653,1.6442721971,12863,975,772,5.7953682397,9271,2.3930634056,14494,4526,2347,26.410028882,14382,1.1615824951,2905,2877
2024-2025,10,06,Montréal,CENTRE UNIVERSITAIRE DE SANTÉ MCGILL,HÔPITAL ROYAL VICTORIA,51223295,37808,6277,943,17.289578991,28673,4.4396879275,22627,1547,409,9.0076063749,13776,6.2870680289,15181,6433,3030,29.633706149,14897,2.7313232717,4730,534
2024-2025,10,06,Montréal,CENTRE UNIVERSITAIRE DE SANTÉ MCGILL,L'HÔPITAL DE MONTRÉAL POUR ENFANTS,51223279,60024,9,1825,5.5583228514,54892,1.6989814343,47160,2,520,4.7000224413,42056,1.9514574483,12864,509,21,8.7048905861,12836,0.8717664728,7,1305
2024-2025,10,06,Montréal,CIUSSS DE L'EST-DE-L'ÎLE-DE-MONTRÉAL,HÔPITAL MAISONNEUVE-ROSEMONT,12934659,55992,9804,3322,12.160835715,38775,3.7277566874,34033,2653,767,5.4756601762,17038,5.3225781423,21959,7748,2405,22.521807485,21737,2.4776960559,7151,2555
2024-2025,10,06,Montréal,CIUSSS DE L'EST-DE-L'ÎLE-DE-MONTRÉAL,HÔPITAL SANTA CABRINI,51235919,29365,7524,1045,14.009089856,22401,3.2977335461,16647,1780,376,5.7018276566,9751,4.899554889,12718,4766,1827,24.882733025,12650,2.0630015371,5744,669
2024-2025,10,06,Montréal,CIUSSS DE L'EST-DE-L'ÎLE-DE-MONTRÉAL,INSTITUT UNIVERSITAIRE EN SANTÉ MENTALE DE MONTRÉAL,51235307,3957,159,3948,12.526744798,3857,1.2812696252,1979,66,1974,3.2643913873,1879,1.3286817752,1978,622,175,21.793780895,1978,1.2362304797,93,1974
2024-2025,10,06,Montréal,CIUSSS DE L'OUEST-DE-L'ÎLE-DE-MONTRÉAL,CENTRE HOSPITALIER DE ST. MARY,51248243,27956,5721,1976,10.670048707,24863,2.8087063776,17474,1719,621,6.2278560528,14408,3.6028402816,10482,2632,302,18.075398302,10455,1.714313141,4002,1355
2024-2025,10,06,Montréal,CIUSSS DE L'OUEST-DE-L'ÎLE-DE-MONTRÉAL,HÔPITAL DE LASALLE,51224392,22968,3627,648,9.7046263642,18360,3.6011616437,17559,1453,230,5.8362257247,12981,4.280600386,5409,1870,678,22.262446078,5379,1.961489899,2174,418
2024-2025,10,06,Montréal,CIUSSS DE L'OUEST-DE-L'ÎLE-DE-MONTRÉAL,HÔPITAL DOUGLAS,51235190,4961,117,4817,13.138221741,4597,2.2326955382,2498,51,2368,4.1001223201,2139,2.3513499299,2463,898,121,22.30475538,2458,2.1294401501,66,2449
2024-2025,10,06,Montréal,CIUSSS DE L'OUEST-DE-L'ÎLE-DE-MONTRÉAL,HÔPITAL GÉNÉRAL DU LAKESHORE,51228278,31083,7560,1880,15.008069926,24995,3.1578248427,18603,2010,245,7.618986633,12575,4.2701867683,12480,4790,1823,26.022422209,12420,2.0315807837,5550,1635
2024-2025,10,06,Montréal,CIUSSS DU CENTRE-OUEST-DE-L'ÎLE-DE-MONTRÉAL,HÔPITAL GÉNÉRAL JUIF,51248250,75772,14418,3917,11.003781234,65230,2.5401301165,26654,1707,385,3.7601962078,17310,2.9217360229,49118,8117,2658,14.934529947,47920,2.4022837426,12711,3532
2024-2025,10,06,Montréal,CIUSSS DU CENTRE-SUD-DE-L'ÎLE-DE-MONTRÉAL,HÔPITAL DE VERDUN,51218097,35072,6326,1986,9.8275319739,29451,2.400400807,23421,2070,736,4.8704479954,17833,3.1282482694,11651,3817,697,19.792330177,11618,1.2831944205,4256,1250
2024-2025,10,06,Montréal,CIUSSS DU CENTRE-SUD-DE-L'ÎLE-DE-MONTRÉAL,HÔPITAL NOTRE-DAME,51236313,31053,4525,4550,11.673180262,26105,2.2382666688,18910,954,1847,5.9052698455,14000,3.1424734127,12143,3522,617,20.655407551,12105,1.1925091789,3571,2703
2024-2025,10,06,Montréal,CIUSSS DU NORD-DE-L'ÎLE-DE-MONTRÉAL,HÔPITAL DU SACRÉ-COEUR-DE-MONTRÉAL,12475976,53512,10134,2421,12.092141794,40331,3.5461309539,36012,3126,956,6.7431501074,22881,5.0214406907,17500,6938,2009,23.099449714,17450,1.6116574817,7008,1465
2024-2025,10,06,Montréal,CIUSSS DU NORD-DE-L'ÎLE-DE-MONTRÉAL,HÔPITAL EN SANTÉ MENTALE ALBERT-PRÉVOST,51848752,2658,105,2650,23.712646831,2624,0.4493887619,1134,51,1126,4.7187708211,1100,0.6402641414,1524,1015,465,37.84588528,1524,0.3116178186,54,1524
2024-2025,10,06,Montréal,CIUSSS DU NORD-DE-L'ÎLE-DE-MONTRÉAL,HÔPITAL FLEURY,51228492,25250,4325,653,9.6571812431,18753,3.6249537111,18272,1591,298,5.6680855802,11804,4.5630897248,6978,2260,329,20.102689405,6949,2.031378016,2734,355
2024-2025,10,06,Montréal,CIUSSS DU NORD-DE-L'ÎLE-DE-MONTRÉAL,HÔPITAL JEAN-TALON,51228500,33939,4464,2711,8.1074166969,24378,3.3774978122,25234,1448,976,5.168680539,15720,4.3801664546,8705,2148,150,16.626206842,8658,1.5569906445,3016,1735
2024-2025,10,06,Montréal,INSTITUT DE CARDIOLOGIE DE MONTRÉAL,INSTITUT DE CARDIOLOGIE DE MONTRÉAL,51248201,16140,4412,389,7.4026314884,15599,1.6158201559,10706,2189,348,3.6096990525,10167,1.8647232604,5434,945,52,14.875420347,5432,1.1499516241,2223,41
2024-2025,10,07,Outaouais,CISSS DE L'OUTAOUAIS,CENTRE MULTISERVICES DE SANTÉ ET DE SERVICES SOCIAUX DE MANSFIELD-ET-PONTEFRACT,51245058,7934,871,189,3.7158223048,7426,1.7426602104,7710,824,179,3.5558069607,7202,1.7428793314,224,8,0,9.2234933036,224,1.7356150794,47,10
2024-2025,10,07,Outaouais,CISSS DE L'OUTAOUAIS,CLSC ET CENTRE D'HÉBERGEMENT DE LA PETITE-NATION,51219491,9392,1179,309,3.6434746475,7936,2.0272247774,8602,934,291,3.5338097406,7151,2.1532071272,790,2,0,4.8375727848,785,0.879581741,245,18
2024-2025,10,07,Outaouais,CISSS DE L'OUTAOUAIS,HÔPITAL DE GATINEAU,51221703,31730,4430,3779,13.364827188,19964,6.3566059184,19460,1451,898,7.4346899623,8351,7.1937435304,12270,3757,1201,22.7699185,11613,5.7546136514,2979,2881
2024-2025,10,07,Outaouais,CISSS DE L'OUTAOUAIS,HÔPITAL DE HULL,51221711,28261,5655,876,13.730912614,19055,5.8551576431,17557,1593,501,7.9336093866,8685,6.9993513401,10704,3810,1348,23.239811415,10370,4.8968816297,4062,375
2024-2025,10,07,Outaouais,CISSS DE L'OUTAOUAIS,HÔPITAL DE MANIWAKI,51221893,11322,1562,652,6.8539913934,9660,2.5606970899,8365,812,330,3.7087468287,6779,2.6824470997,2957,577,223,15.751512794,2881,2.2742190212,750,322
2024-2025,10,07,Outaouais,CISSS DE L'OUTAOUAIS,HÔPITAL ET CHSLD DE PAPINEAU,51228823,19873,2500,844,8.7147745965,14402,4.4252193175,14566,1053,327,4.7177537111,9193,4.7572096221,5307,1521,389,19.685305257,5209,3.8393128346,1447,517
2024-2025,10,07,Outaouais,CISSS DE L'OUTAOUAIS,HÔPITAL ET CHSLD DU PONTIAC,51219459,10196,1220,314,5.8283100126,9234,2.4969072931,9224,993,225,4.8365265732,8265,2.5585594542,972,171,42,15.240049154,969,1.9710506249,227,89
2024-2025,10,07,Outaouais,CISSS DE L'OUTAOUAIS,HÔPITAL ET CHSLD MÉMORIAL DE WAKEFIELD / WAKEFIELD MEMORIAL HOSPITAL,51228799,14001,1145,300,5.8207330627,11307,3.4610046628,12348,756,207,4.7017186994,9681,3.6099513078,1653,273,38,14.179831283,1626,2.5741950253,389,93
2024-2025,10,08,Abitibi-Témiscamingue,CISSS DE L'ABITIBI-TÉMISCAMINGUE,CENTRE MULTISERVICES DE SANTÉ ET DE SERVICES SOCIAUX DE LA SARRE,51247559,15220,1939,766,6.0112350161,13382,2.9178796559,12358,1141,578,4.9509649844,10565,3.0789259873,2862,299,37,10.589438039,2817,2.3138844515,798,188
2024-2025,10,08,Abitibi-Témiscamingue,CISSS DE L'ABITIBI-TÉMISCAMINGUE,CENTRE MULTISERVICES DE SANTÉ ET DE SERVICES SOCIAUX DE TÉMISCAMING-KIPAWA,51247476,4324,437,285,2.4985707036,4069,0.9402187952,4055,358,257,1.9441874229,3801,0.9584960829,269,15,0,10.855538001,268,0.6809950249,79,28
2024-2025,10,08,Abitibi-Témiscamingue,CISSS DE L'ABITIBI-TÉMISCAMINGUE,CENTRE MULTISERVICES DE SANTÉ ET DE SERVICES SOCIAUX DE VILLE-MARIE,51247542,9792,1365,457,4.9373433529,8387,2.8203928368,8269,904,309,4.041983076,6890,2.9222093614,1523,61,7,9.7986264318,1497,2.3517783716,461,148
2024-2025,10,08,Abitibi-Témiscamingue,CISSS DE L'ABITIBI-TÉMISCAMINGUE,HÔPITAL D'AMOS,51228906,20452,2234,831,4.8716967914,18373,2.0914187334,15595,985,638,3.4909655338,13571,2.3376128632,4857,352,22,9.3049897628,4802,1.3956460271,1249,193
2024-2025,10,08,Abitibi-Témiscamingue,CISSS DE L'ABITIBI-TÉMISCAMINGUE,HÔPITAL DE ROUYN-NORANDA,51228922,22195,2950,1256,7.3250202999,16974,4.2260394983,17967,1533,858,6.4625342758,12812,4.8096941019,4228,324,5,10.990177914,4162,2.4293593491,1417,398
2024-2025,10,08,Abitibi-Témiscamingue,CISSS DE L'ABITIBI-TÉMISCAMINGUE,HÔPITAL DE VAL-D'OR,51225589,22076,2566,1377,8.3356466676,17630,4.4112580513,18176,1492,987,6.4263597143,13746,5.0198224938,3900,1012,216,17.233902991,3884,2.2574663863,1074,390
2024-2025,10,09,Côte-Nord,CISSS DE LA CÔTE-NORD,CENTRE MULTISERVICES DE SANTÉ ET DE SERVICES SOCIAUX DE FERMONT,51245108,5016,34,325,5.9720975656,4390,2.6783895849,4717,28,298,5.822825772,4093,2.7553444906,299,4,1,8.3269973987,297,1.6178628881,6,27
2024-2025,10,09,Côte-Nord,CISSS DE LA CÔTE-NORD,CENTRE MULTISERVICES DE SANTÉ ET DE SERVICES SOCIAUX DE FORESTVILLE,51218741,8344,1228,440,3.9682999427,6798,2.2630261351,7214,895,351,3.3434391076,5795,2.4431963858,1130,57,9,7.9574557522,1003,1.2220624238,333,89
2024-2025,10,09,Côte-Nord,CISSS DE LA CÔTE-NORD,CENTRE MULTISERVICES DE SANTÉ ET DE SERVICES SOCIAUX DE LA BASSE-CÔTE-NORD,51245140,2915,462,102,2.7050483133,2851,0.8552633579,2455,338,89,2.4663265445,2391,0.8783092848,460,1,0,3.9790960145,460,0.7354746377,124,13
2024-2025,10,09,Côte-Nord,CISSS DE LA CÔTE-NORD,CENTRE MULTISERVICES DE SANTÉ ET DE SERVICES SOCIAUX DE LA MINGANIE,51245116,9346,974,340,3.8984658321,5642,2.6546490114,6183,662,126,2.1901679785,2569,2.7641379049,3163,145,9,7.2378289774,3073,2.563117294,312,214
2024-2025,10,09,Côte-Nord,CISSS DE LA CÔTE-NORD,CENTRE MULTISERVICES DE SANTÉ ET DE SERVICES SOCIAUX DE PORT-CARTIER,51245132,11582,1018,477,5.9194496249,9743,3.1973229498,10632,795,414,4.8601099929,8805,3.3480090542,950,205,79,17.775132749,938,1.7828334518,223,63
2024-2025,10,09,Côte-Nord,CISSS DE LA CÔTE-NORD,CENTRE MULTISERVICES DE SANTÉ ET DE SERVICES SOCIAUX DES ESCOUMINS,51218733,8184,1219,343,4.2448897917,7107,1.9249396526,7183,834,284,3.4751682213,6129,1.9813467395,1001,61,5,9.7682764458,978,1.571443706,385,59
2024-2025,10,09,Côte-Nord,CISSS DE LA CÔTE-NORD,CLSC ET HÔPITAL LE ROYER,51228765,17911,2637,1106,9.2543666369,15454,3.8662867578,13235,1131,561,5.9802663183,10787,4.5327152797,4676,1213,455,18.521414908,4667,2.3259472538,1506,545
2024-2025,10,09,Côte-Nord,CISSS DE LA CÔTE-NORD,HÔPITAL ET CLSC DE SEPT-ÎLES,51232023,17190,2060,1350,9.0671889665,12943,4.6746663576,11960,860,554,6.0433149619,7858,5.2558653601,5230,1002,234,15.982204854,5085,3.7765224517,1200,796
2024-2025,10,11,Gaspésie-Îles-de-la-Madeleine,CISSS DE LA GASPÉSIE,CENTRE MULTISERVICES DE SANTÉ ET DE SERVICES SOCIAUX DE GRANDE-VALLÉE,51247732,5489,1051,138,2.2905468007,4267,1.1883519517,5204,935,132,1.9952590956,4000,1.2199858333,285,20,3,7.6823966862,267,0.7144361215,116,6
2024-2025,10,11,Gaspésie-Îles-de-la-Madeleine,CISSS DE LA GASPÉSIE,CLSC ET CENTRE DE SERVICES AMBULATOIRES DE MURDOCHVILLE,51221307,1647,224,69,3.4593193011,1571,1.8126601952,1605,208,69,3.3801825891,1530,1.8364315541,42,1,0,6.4834722222,41,0.9255826558,16,0
2024-2025,10,11,Gaspésie-Îles-de-la-Madeleine,CISSS DE LA GASPÉSIE,CLSC ET CENTRE DE SERVICES AMBULATOIRES DE PASPÉBIAC,51220978,11173,1998,401,4.0968822409,10356,1.989295792,8132,1224,306,3.2939193242,7419,2.1035276917,3041,97,10,6.2441017209,2937,1.7007406462,774,95
2024-2025,10,11,Gaspésie-Îles-de-la-Madeleine,CISSS DE LA GASPÉSIE,HÔPITAL DE CHANDLER,51227775,13823,2290,491,5.0357595634,11894,2.3687153186,12021,1524,390,4.0895753496,10104,2.5256589799,1802,119,2,11.347679893,1790,1.4828165736,766,101
2024-2025,10,11,Gaspésie-Îles-de-la-Madeleine,CISSS DE LA GASPÉSIE,HÔPITAL DE GASPÉ,51220903,11724,1823,449,5.3160316682,10045,1.7373992036,9304,1080,255,3.6767681463,7680,1.9883094618,2420,253,23,11.618390266,2365,0.9226039464,743,194
2024-2025,10,11,Gaspésie-Îles-de-la-Madeleine,CISSS DE LA GASPÉSIE,HÔPITAL ET CLSC DE SAINTE-ANNE-DES-MONTS,51247799,11415,1944,472,5.6479377768,10193,2.2665735745,9019,1138,299,3.4811871543,7820,2.4552393791,2396,406,96,13.80399949,2373,1.6448430257,806,173
2024-2025,10,11,Gaspésie-Îles-de-la-Madeleine,CISSS DE LA GASPÉSIE,HÔPITAL ET GROUPE DE MÉDECINE DE FAMILLE UNIVERSITAIRE DE MARIA,51227908,14095,2490,706,6.4610249695,12794,2.2949245306,10520,1255,339,4.0782775137,9231,2.5703257141,3575,613,85,13.472634266,3563,1.5814167212,1235,367
2024-2025,10,11,Gaspésie-Îles-de-la-Madeleine,CISSS DES ÎLES,HÔPITAL DE L'ARCHIPEL,51227783,12759,1924,383,4.8723202358,10950,1.9187142314,10293,1252,192,3.3861806837,8519,2.0380738806,2466,263,58,11.075416103,2431,1.5004399196,672,191
2024-2025,10,12,Chaudière-Appalaches,CISSS DE CHAUDIÈRE-APPALACHES,CHSLD ET HÔPITAL PAUL-GILBERT,51245199,33775,2811,373,2.7754969159,26513,2.0845223727,33706,2790,372,2.7760650923,26444,2.0891466558,69,0,0,2.4979468599,69,0.3122826087,21,1
2024-2025,10,12,Chaudière-Appalaches,CISSS DE CHAUDIÈRE-APPALACHES,HÔPITAL DE MONTMAGNY,51245223,29318,4498,917,4.5248450705,27015,1.6657479178,23351,2475,526,2.7713905305,21054,1.9354187249,5967,672,46,11.386738311,5961,0.7132820276,2023,391
2024-2025,10,12,Chaudière-Appalaches,CISSS DE CHAUDIÈRE-APPALACHES,HÔPITAL DE SAINT-GEORGES,51228971,36490,6617,1759,6.7328562239,30227,2.6625659822,25773,2761,839,4.4511486504,19555,3.4114749709,10717,1342,100,12.220068064,10672,1.2902913127,3856,920
2024-2025,10,12,Chaudière-Appalaches,CISSS DE CHAUDIÈRE-APPALACHES,HÔPITAL DE THETFORD,51245231,32124,5345,1017,6.1495472319,29207,2.1492166642,25682,2922,548,4.2270249375,22771,2.4463899746,6442,1102,106,13.813970946,6436,1.0977975451,2423,469
2024-2025,10,12,Chaudière-Appalaches,CISSS DE CHAUDIÈRE-APPALACHES,HÔTEL-DIEU DE LÉVIS,51227569,61791,12205,4223,9.0157564658,54829,1.7718448317,42262,4796,1979,3.9139230212,35311,2.2939698677,19529,5346,2013,20.056449027,19518,0.8272420472,7409,2244
2024-2025,10,13,Laval,CISSS DE LAVAL,HÔPITAL DE LA CITÉ-DE-LA-SANTÉ,51228757,72780,14079,4774,10.803477795,56029,3.7701796094,45587,4271,1020,6.4820036901,28962,4.8479119958,27193,7138,760,18.048101043,27067,2.6169936126,9808,3754
2024-2025,10,14,Lanaudière,CISSS DE LANAUDIÈRE,HÔPITAL DE LANAUDIÈRE ET CENTRE D'HÉBERGEMENT PARPHILIA-FERLAND,51244945,59158,10587,3989,9.5340931113,46290,2.8682931999,37947,3165,2719,5.6716784301,25219,3.8927409559,21211,5273,743,16.444047847,21071,1.6421744604,7422,1270
2024-2025,10,14,Lanaudière,CISSS DE LANAUDIÈRE,HÔPITAL PIERRE-LE GARDEUR,51228062,63771,11949,3658,10.605696106,44138,4.2025253938,43123,4119,1234,5.9034411322,23548,4.9803727493,20648,7276,914,20.426276368,20590,3.3129309535,7830,2424
2024-2025,10,15,Laurentides,CISSS DES LAURENTIDES,CENTRE MULTISERVICES DE SANTÉ ET DE SERVICES SOCIAUX D'ARGENTEUIL,51245306,17182,2378,560,7.7715227822,13314,3.7373775099,14187,1358,380,5.6221269472,10328,4.2777816507,2995,722,149,17.952984789,2986,1.8682234688,1020,180
2024-2025,10,15,Laurentides,CISSS DES LAURENTIDES,CENTRE MULTISERVICES DE SANTÉ ET DE SERVICES SOCIAUX DE RIVIÈRE-ROUGE,51217628,11154,1348,553,6.8818093409,9571,3.2817378597,8513,704,280,4.6086890964,6993,3.4826297329,2641,478,102,14.208985654,2578,2.7368050168,644,273
2024-2025,10,15,Laurentides,CISSS DES LAURENTIDES,CENTRE MULTISERVICES DE SANTÉ ET DE SERVICES SOCIAUX DE SAINTE-AGATHE,51246874,26091,4883,1530,11.025513289,20148,4.299492795,17292,1930,496,6.6264890476,11425,5.4596643569,8799,2688,447,19.670578317,8723,2.7799513419,2953,1034
2024-2025,10,15,Laurentides,CISSS DES LAURENTIDES,HÔPITAL DE MONT-LAURIER,51217610,15147,2262,677,8.9154772489,12477,3.3439729324,11311,1171,331,5.9927170945,8694,3.6345817678,3836,911,206,17.533657673,3783,2.6761026669,1091,346
2024-2025,10,15,Laurentides,CISSS DES LAURENTIDES,HÔPITAL DE SAINT-EUSTACHE,51228864,42641,9006,2460,12.704194711,30842,3.7667870382,25260,2464,527,6.9962628222,13573,5.4136604738,17381,5938,1468,20.999595408,17269,2.4723859067,6542,1933
2024-2025,10,15,Laurentides,CISSS DES LAURENTIDES,HÔPITAL DE SAINT-JÉRÔME,51228880,49719,9154,4662,14.836517623,37214,4.1011652649,28843,2854,1308,6.4657843709,16462,5.447315906,20876,7539,3546,26.401810745,20752,3.0333003914,6300,3354
2024-2025,10,16,Montérégie,CISSS DE LA MONTÉRÉGIE-CENTRE,HÔPITAL CHARLES-LE MOYNE,51233799,60443,11489,4883,10.88738724,35710,5.2771305423,41363,4409,1797,6.3096337642,16646,6.107333894,19080,7089,787,20.81137136,19064,4.5522267975,7080,3086
2024-2025,10,16,Montérégie,CISSS DE LA MONTÉRÉGIE-CENTRE,HÔPITAL DU HAUT-RICHELIEU,51229045,47602,8684,2925,12.19937023,33959,4.7782386358,32925,3307,924,6.8738432127,19360,6.0845861169,14677,5179,2431,24.146156155,14599,3.04586743,5377,2001
2024-2025,10,16,Montérégie,CISSS DE LA MONTÉRÉGIE-EST,HÔPITAL HONORÉ-MERCIER,51229193,37284,7597,2158,10.300421651,27149,5.0605365555,20553,2716,823,6.2732425518,10610,6.6044378993,16731,3427,652,15.247562409,16539,4.0701022331,4881,1335
2024-2025,10,16,Montérégie,CISSS DE LA MONTÉRÉGIE-EST,HÔPITAL PIERRE-BOUCHER,51229011,46471,10325,2869,12.836785008,33987,5.2526808862,21770,3092,878,6.8347351733,9551,7.0227374388,24701,6105,1830,18.12663663,24436,4.5608405631,7233,1991
2024-2025,10,16,Montérégie,CISSS DE LA MONTÉRÉGIE-EST,HÔTEL-DIEU DE SOREL,51229102,29657,5182,1428,8.3691900076,24090,3.077990637,20106,2126,457,4.6076374382,14635,3.5225566564,9551,2347,370,16.287709111,9455,2.3898654445,3056,971
2024-2025,10,16,Montérégie,CISSS DE LA MONTÉRÉGIE-OUEST,HÔPITAL ANNA-LABERGE,51229151,29157,6375,1923,16.332672657,23703,1.9620322439,16833,1639,412,8.4981483297,11381,3.5102208847,12324,5196,2129,27.03362592,12322,0.5320748571,4736,1511
2024-2025,10,16,Montérégie,CISSS DE LA MONTÉRÉGIE-OUEST,HÔPITAL BARRIE MEMORIAL / BARRIE MEMORIAL HOSPITAL,51228005,17474,1909,330,6.5719391032,14632,3.3186854535,14937,1166,262,4.7413207695,12102,3.4407281166,2537,641,121,17.35000219,2530,2.7349066755,743,68
2024-2025,10,16,Montérégie,CISSS DE LA MONTÉRÉGIE-OUEST,HÔPITAL DU SUROÎT,51229136,32362,5789,2638,12.056147908,25259,2.3542413375,18819,1444,1365,4.4695433398,12232,3.1583175505,13543,3942,2063,22.598295983,13027,1.599235562,4345,1273
